tweet	label
خاطيك علابالي 🕊️	positive
وقتاش يجي الشتاء راني باغي نتغطا	neutral
الحاج قتلتنيييي بالضحك 🤣 🤣 🤣 🤣 🤣 🤣 ،،، مليحا بزاف	positive
مرحبا بيك كلبي	negative
الجزائر جنة 😍🇩🇿 وقتاش تلحقينا 😅	positive
الفطاير في جيجل\nعيدك مبارك ينعاد عليك بخير وصحة وسلامة	positive
خصنا كراء بيت في جيجل	neutral
مسكين غاضني واش بيه هكذا	negative
مرحبا بيك في ادرار (الجزائر)	positive
كما قلنا سابقا كلمة ""قهوي"" لم تأتي من فراغ بل هي مشروع لعزل الأغلبية على الساحة و فرض أفكار تاجمعت عليهم قصرا و الا…	negative
خدايم القرش واقيلا	negative
RT الحمامات هذي خدموهم علجال لي نجح بالغش يتبهدل تبهديلة العمر ...😅	negative
😂😂😂😂شام الوحيدة الي تحب الزمالك زكارة في الاهلاوية 😭😭😂😂😂تحبي ديريها زكارة نعرفك	negative
😂😂 شوف التصاور لوخرين هذي واقيل فوتوشوب و لا حطولو كرسي 🤣	negative
اعود باالله من كلامة انا الي نخسرها في شهر المراة تخسره في عام نساء واش يخسرو💅 👄مكياج بارك حليلو الرجال…	negative
مرحبا بيك في اي وقت	positive
RT زعما بعدوها على الجامع	negative
الرجال قادرين علاها بلا مزية حتى واحد	positive
اسمحيلي بصح ماكاش لازم تحليلهم الدصارة تع الفايسبوك . الا سحقو كاش حاجة يقولوهالك فالقسم	negative
علابالي سايري بالعقل متقلقيش هذي هي المواقع اعرف كيف تمشي 🤗😂😂😂😂	positive
زعما يكومونتي😂	negative
سوق اهراس مهيش تابعة دزاير واقيل؟؟؟	negative
أنا جامي نشكي مالفوطوكوبي تاع حاجة بيومتريك، لأن البديل ""ماكاش الريزو مانقدرش نتأكد مالمعلومات""\nThe horror	positive
اه علابالي الصحراء تقدر ترجعها جنة بصح المشكل الارادة مكانش .	negative
الجزائر من نهار إستقلينا وهما يسرقو مفقرتش مزية ربي يشوف لينا	positive
العاب البحر الابيض المتوسط ، الزوالي فالقلب 😑☝️	negative
بزاف😍	positive
هادوك البنات لي ميحبوش يحطو تصاورهم وميتصوروش بزاف تلقاهم كامل زلات 😩💗	positive
هههه واش من KO ؟ ينبح أمبعد يبلوكيني ؟ هذي هي الشجاعة يا أبناء الزريبة ؟ واصلوا نباحكم.	negative
شرب كاش حاجة قبل ما يلقي الخطاب مافيهاش هدرة😂😂😂😂😂😂😂😂😂😂😂😂	negative
محرز لايت هذا واقيل هذاك صاحبو اللي يظل معاه فاتح فو كونت	negative
اواه علابالي خو كاين مقاهى والله غير حسبو بيين قالك بززاف ياخي قهوة انت خدام داخلك ولا غير حبسوها	neutral
لما تمشي لسوق الفريب وتركن سيارتك الحقيرة بجنب سيارة فخمة اخر طراز تابعة لوزارة مانحبش نسميها .\nتقول. علاش قلة الذو…	negative
اللهويرحمهم و الله يصبرنا على فراقهم، صعيبة بزاف	positive
ما عرفتش علاش كي شفت الفيديو تفركت نيشان الخلايجة 😂	neutral
مرحبا بيك في العائلة	positive
الشروق هذه من خرجت وهى نتاع تبهديل، مستوى منحط وشعبوي ....	negative
اه امبعد واش راح تفيدهم ما عندكم والو غير الزلط والهدرة في المواقع انتم بنفسكم راكم مديونين	negative
RT منافق و كذاب لا نريدكم اخطونا اخطونا اخطونا اخطونا اخطونا اخطونا اخطونا	negative
تبهديلة عابرة للقارات هههههه	negative
علابالي لازم الخروج يكون بقوة ما عندهم ما يديروا	positive
شكون هدا خوك و لا انت🤣🤣🤣	neutral
نيشان والله ،حابسين في عصر الجاهلية ، وفرحان بروحه وڨاع	negative
هيه قصدي الشخصية لي وهمية ... بصح ادا كان جندي ماعلاباليش ادا صح	neutral
علابالي نخطيكم انا تضيعو 😌	negative
انا لا اؤمن بالجهوية\nانا جزائرية ب 58 ولاية\nفقط وضحتلك انو اصلو من دشرة\nمادام راه يضحك على القهويين… ,	negative
و في الدزاير ماكاش منظومة صحية متطورة؟!؟!	neutral
علابالي بيك عفريت كبير صاريلك كما الحوت مايتحكمش ههههه	negative
ما عندو حتى معنى ...جياحة تع مراهقين وخلاص	negative
ان شاء الله ترجعي علابالي لك وحشة اتهلاي في روحك واحنا هنا وقت ما حبيت بسلامة بالاكي تبعدي بزاف 😏😅😅	positive
معلومة= جهل من عند أيوب. وعلاه يا خويا وعلاه 😭😭🤣	negative
واقيل فودن ميعرفش يلعب بففففف	negative
و طويلة بزاف هههه	negative
آمين يارب \nبلا مزية جارتي 💜🌸	positive
بالامين حدثلي خلاف مع مجموعة أصدقاء و قررت أقطع علابالي معهم بعدم احترامهم لي مع أمي أعاملهم باحترام كبير	negative
ليكيب تاعك ؟ نتا واقيلا مريض شوية، الفووت نعلمهولك انا ولد الناس، واقي…	negative
😥😥غاضتني😥	negative
خو العلاج مع الخيل يا شقرا	negative
نحبهم بزاف بزاف	positive
جزائري ولست منهم هادو الذين اعطوك الدروس التهريجية	negative
ياخي حالة ياخي اللي يخموا كيفك عندهم إنفصام بالشخصية يتسمى حتى باباك هذه طبيعته واقيل إرتقوا شوي القاع إمتلاء بالحمقى	negative
ماكاش تعليق ترد فيه على الكنديبن يا منزوع الإرادة عديم الشرف	negative
on da\noff da \nواقيل قلتهالك ديجا منقبل😭😭	neutral
ايلا كان ديجا حاط عينيه مانتسناوش بزاف 🤭😂😂	neutral
قهوي ؟ علابالك بلي الناس كي تقول القهويين تقصد القبايل ؟\nياخي بني عداس يازح	negative
رآها قالوا لاولين لبغا الجمال يطلع لشمال كانوا واقيلا كيعنو شمال أروبا او شمال أمريكا	negative
مزية مقلتش 😹	positive
و بزاف على هواية ههه بالصحة و الراحة	positive
علابالي دول عالم الثالث متخلفين نعتامدو على لغة لن تفيدنا في شيء \nالناس طار با…	negative
عادي لوكان ضرك يقولولوا اشطح يشطح😂😂	negative
روحي تتعشاي أمبعد أنقلك	neutral
شفتي على تبهديلة😭😭\nالقراية كلها تضربت في زيرو	negative
والله نضحك هذا مكان \nأصلا مكانش من الأساس\n وعلاه صعيبة بالعكس أنا اطيب مما تتصور	positive
زعما راه دار شي انجاز غير مسبوق 🤦🤦🤦	negative
نعم وناس عنبالهم جياحه	negative
هههههههههه هي اي لقطة تعهم غاضتني كي قالي طاطا هههه انا طاطا انا مزلت صغيرة على روحي نسيت بلي في يد…	negative
ساواصل، درتي فيا مزية حسابي موجود على حسابك جبتيلي متابعين جدد شكرا لك	positive
لازمنا نحاولوا ونحاولوا هذي بلادنا علابالي اليأس سيطر علينا ولكن	negative
ايا مزية ..الحمدالله	positive
ههههه سقسي اختك لي دير روتيني اليومي تقولك	negative
كول واعر يا ختي سلمى جبتيه في الشبكة نيشان 👌👌👌👌	positive
لوكان جات بلاد لوكان راهم بعتو بلخادم للقبو ماشي للحراش كي عرفوه عميل لديك الدولة اللي علابالي لوكان نسميها تبداو مامشكلتك مع الكاش حاجة.	negative
التاريخ زعما؟	neutral
هههههههه علابالي غير انت لي تقول لااااا هههههههههه	positive
وقتاش اول محرم ؟	neutral
هو اللي يتبهدل أكثر من تبهديلة إفريقيا 😁😁	negative
خويا املاكه الخاصة داخل بيته بصح لما الصوت يرجع يملأ الحي كله فهذا تعدي... انت ضروك ما تخسر…	negative
بزاف واقيل روحو نجوزو عطلة تم	neutral
ماكاش لي ما علابالوش بلي نتي عاقلة.حقا كاين وحدة حابة تدابز واش رايك نروحو نعطوها طريحة	negative
علابالي بلي انا اللولة لي نكره و ننسحب 😂	negative
نيشان ، شكرا على التعليق خويا✌🏾🙏🏾🤍	positive
بعد زيارة الكيان ص ه ي و ن ي الغيت كل النشاطات 🤨 الفرح والبهجة و مهرجانات ونار تحرق م جمدوهم باينة بعد…	negative
منحة التمدرس روح سقسي الناس اللي عندها ربعة وخمسة ولاد، قلهم علاش يمدو لزوز ولاد ولوخرين يقلك مايدو…	negative
الصيف هذا حوست بزاف،...\nماكاش بلاصة في دارنا مارقدتش فيها	positive
بحروش سقسي زوجك العنابي دوك يفهمك 😂	negative
فور بزاف هذي الصورة.	positive
وعلاه. خليها. حرية شخصية	neutral
هههه .مزية ولا كان تقطع النسل من زمان	positive
RT من وقتاش قطر عندها تاريخ في كرة القدم!!!🤔😅	negative
زعما الناس رايحين يقراوه صح؟	neutral
تعمل مزية يفضلك 🤣	positive
وعلاه لا هههههههه	neutral
انا لست بساحر بصح علابالي راك قاعد دك و خاصك دراهم\U0001faf0	positive
وعلاه ما يستعملوش الجير كما بكري؟ سهلة و مشي غالية.	positive
وعلاش ياليل بليتيني بالتخمام !	negative
العرق جبَّاد يا خو	neutral
علابالي...\nبفعل فاعل الف بالمائة\nبصح شكون ؟؟؟\nأنت لي تريح عاقل وماتسخنش بزاف\nوأنت أمنت بها.…	negative
شفت ثلث حلقات ماعجبونيش الكوبلز، ماكاش chemistry بيناتهم، البطل لي نورماملو متنمر كي يزعف يولي كيوت ت…	negative
خرجت من الدار ب 50 دج!! انا راسي حبس و غاضتني و زادت قاتلي هي الصغيرة و عندها 4 د خاوتها ...و قاتلي (جامي شفيت على…	negative
هادي زعما كي تقشر البيضة جيك تمتم اذا غليت البيض مع الليمون	neutral
(إن شاء الله 😊🥀)وعلاه راك تضحك🙄🙂😭	positive
كلمة عنصربة..\nوكل لي راه يتفلسف بش يلقى تبريرات.. قهوي🤣	negative
كاين لي يخليها زكارة	neutral
جياحة يقولولها 😒	negative
ومالنا زعما واش من قلت الذكاء ولا من قلت الامكانيات..	negative
جميلة جدا شواطئ تلمسان "" تسكاله""	positive
ههههه شفت داار فينا مزية	positive
مغاضتنيش كي بدلت اسمها مستخدم فيسبوك غاضتني كي نحاتلي الكلافي	negative
بزاف عليك	negative
اذا عندك بزاف مشاكل ومعندكش دراهم وحياتك خرا معندي منديرلك🙂👽	negative
فعلا عندك الحق ردود الفعل هي مرآة لتفكير الإنسان بالمناسبة غاضني الحال على دراهم الشعب…	negative
صباح النور الله يسلمك مزية سلكنا ههههه	positive
مير سكران وكل مرة يصوروه يكون لابس نفس اللبس هههه هههه تبهديله والله	negative
ماشي شابة أنا نبغيها 🧸🥺\nمتعرفش تهدر أنا نبغيها 🧸🥺\nتضحك بزاف أنا نبغيها 🧸🥺\nتزعف بالخف أنا	positive
وقتاش نوضوك ؟	neutral
وعلاه بطلتي الخير رجعلك شر	negative
مش خسارة فيك يا خو.....	positive
وي خويا لعزيز راهم هربو واقيل 🤣🤣🤣🤣💪💪💪💪	negative
علابالي مزال الحال علابالي مزال نحب ... مزال لمحان ... مزال قلبي يزيد يكحال🖤	negative
باش يشوف اذا راكي تخمي فزواج و لا لالا، باش امبعد يعرف اذا رفضتيه لشخصو و لا راكي رافضة فكرة الزواج ككل 😂	neutral
فكرتيني حلمت بن زيما مرض وجابو بلايلي يلعب فبلاصتو فالريال ماعلاباليش كفاه يلعب فبلاصتو ماتسقسينيش الم…	positive
طاقي تيكتوكر لي تحبو بزاف اذا ريبوندالك اعرفو بلي مشي متكبر🥰👋	positive
😂😂والله العظيم اللي نعيدلو يروح راكب نيشان	neutral
منعرف سقسي لي جربوه \nخاطيني الحب \nنعرف نحب غير قطوطة	negative
ههههه لبروبلام علابالي هيه بصح هذيك افكاري برك 🤣🤷	neutral
علابالك ماشني قاعد للتوافه هذي لانو انت علابالك و…	negative
حسبته دشن كاش حاجة	neutral
مخترع كاش حاجة	neutral
ممم ،منديتا كان لعب في البارصا واقيلا !	neutral
كيفاش زعما ؟	neutral
ياحسراه علابالي بلي حبيبتي زيتونة جامي تروح رحلة بلا بيا تكون وجدتلي بلاصة مع اللولين😍😭😭😭😭	positive
ههههههه راني نشوف غاشي بزاف راه مخبي	neutral
والله نعزك على هادي غاضتني	positive
تبهديلة من بعدها تبهديلة	negative
قريب مابقاش بزاف هههههه	positive
وقتما نبغي الفلوس نطاكيك نيشان	negative
هذي تهاجم الجزائر ولا النظام لحاكم الجزائر؟\nواقيلا ماعلابالكش بلي اغلب المسؤولين عندهم جنسيه فرنسي…	negative
هههههههه مزية فكرتني 🤭	positive
ممكن تخبرونا عن الحاله كيفاش راهي ضرك ؟!	neutral
وضوح الشمس فنهار جميل واضح وباين..وعلاش يكذبننننني علاش!😆	positive
راك أدخل في الجزائر 🇩🇿💪 كاش ماتساللها أرواح تخلص 😠 \nألي ضراتوا كاش حاجة ادخل الجزائر عيشوا حياتكم علاه اتعيشوا حياة الناس	negative
زعما وين	neutral
جياحة حقربي	negative
نخاف الي نعرفهم في حياتي تاع الصح يصيبو تويت و يقولولي ياه هذا كونت تاعك! تبهديلة😭😭😭	negative
وعلاه ماتريحش في دارها مع زوجها كاين رجل يتحرش ومراة تتحرش ويوقع هو في مصيدة واحدة والعكس تلبس الميني…	negative
يبقاو الجنرالات عقدتكم 😭 حنا نحبوهم كي نتوم تكرهوهم \nزكارة 🤪 تسالونا !!	negative
لا مكانش منها قع، قتلك فيها مظلومية زايدة برك\nدور فاليوتوب تلقاهم كامل يمعنيو قهوي على صاحب السلوك السيء.	negative
التهاو برواحكم عندكم فياضانات و جفاف و مشاكل قد السما اخطونا برك	negative
بلا مزية	positive
كبيرة بزاف	negative
صباح النور والسرور 🌼💓💐\nواقيل راه هكذاك راح نرجع 🤣🤣🤣🤣🤣🤣	positive
الحد الأقصى واقيلا	neutral
😔😔😔😔😔 \nماكاش واحدة نعاملو بحنية قد قطي كل زوج دورات نعنقو نبوسو 🥰	positive
و شكون عرف 😂😂😭😭😭	neutral
علاش كارثة زعما ياك لاباس؟	negative
وقتاش ينقصو من الاسعار	positive
هادشي واقيلا من قبل ما نعرفك 😂😭	positive
نهدر و نضحك معا ڨاع الناس بصح \nعلابالي شكون الذيب و شكون الحبيب😶	neutral
تعوم في البحر راك تفوسختي نيشان ومنها تشد لوين ذهبي جميل	positive
ياو ماشي متوفر ميحتسبش الإستماعات تاعك سقسي	negative
علابالي ما راكش فاهم والو ،تفهم غير ففهامتك ،لأنك تظن بالناس السوء وتظن أنك الضحية وتتخذ د…	negative
هذا هو معنى: في كل الظروف 💪🏻 علابالي قليل لي يفهمها \n تحية كبيرة لجيشنا الوطني الشعبي\n🇩🇿\U0001fae1	positive
لو بهذاك المبلغ امنولو كاش حاجة تعاونه احسن	negative
وقتاش ؟!\nاه على العرض العسكري هههههه لا غير عاودها ذاك نهار كنت مقلقة	negative
بربوشة سطيف مليحة ولا والو	neutral
👌🏻😂 علابالي تفهمني	positive
186×80= رياضي 😌 سقسي الكوتش او شوفي مع البقية 🤣🤣🤣	neutral
شفت كيفاه !!\nلوكان راك رايس ولا حتى وزير لوكان مايصراوش هاذ الحرائق. هاكا ؟ \nشفت كيفاه ماخلاوكش حتى تأدي…	negative
كامل الامراض سبتهم تلفون . وذا مصدقتنيش سقسي يماك	negative
كاين بزاف ولكن الزين غالب	positive
راك تتخبط علابالي بيك	negative
شكون عندو صح زيطزيط ومازدة واقيل	negative
RT ايا ضرك هاذي دولة \nلكم التعليق	negative
وعلاه كاين ياعائشة ربي يديمك معنا أخت معززة مكرمة	positive
شوفو مع الناس لراهي تشردت امبعد ساهل حصلوا في الناس وديرولنا افلام ماعندها حتى معنى	negative
حصلوا عندك زوج بريكات واقيلا	negative
انت من الشرق وكي تكتب نيشان يحسبوك من الغرب	neutral
علابالي ماش عندنا و باينة ماتحتاجش توضيح راه صفحة تاع الكذب و الفتنة	negative
من وقتاش اصبحت حنين وتصبح	positive
طعمووك و طلقوك كي الهايشة \nروح سب روح اطلڨ لخنز تاع فمك\nم…	negative
راك غي تخلط ، اذا كنت صح حقاني تفهم لحكاية وحدك ، اذا بيك كاش حاجة خلاف مانيش لاهيلكم	negative
شكرا يادكتورة.. اصلا نحن ماعندنا بحر. هههههههه \nقصدك انديروها. زعما. 😎	positive
ما راكيش بعيدة بزاف \n44	neutral
العمرة ساعتين والحج يوم واحد، تروح الصباح ترجع العشية\nوعلاش لا الأستاذة ممكن تساهم بأفكارها\nترقبي التغيير الحكومي ا…	positive
أنا أسهل بنادم تقدر تخرجت من حياتك . ما نسقسيك علاش لا وقتاش ولا كيفاش 😂😂🖕	positive
هاهو جا وستقلبلتوه!!! ولكن السؤال ماذا استفادت الدول المشاركة واليابان من عصابة تسكن في الخيام ليس عندها حتى مقوما…	negative
🤣🤣🤣🤣 يا ولدي قوليلو بين روحك برك، ديؤرقناة يوتوب هههه، او انشر مقال في le soir و امضي انك…	neutral
ههههههههههه زعما الجزائر هي من تملك القرار الاخير 🤣🤣🤣🤣	negative
من العادات الجميلة بولاية #سطيف، هو اخراج مأدبة غداء الى الشارع، ليأكل منها من يمر امامك، و غالبا تكون البربوشة ب…	positive
غاضني الشاب هذاك وحتى طفل صغير تع باباك أو جاي	negative
😂😂😂😂😂\nتتعاطاو نوع جيد من الحشيش ولا واش 😳😂😂😂\nسقسي…	negative
والله ما علابالي منين نبداه 🥴	negative
ياو اخطونا من التجميد و التنديد هذه لغة الضعفاء من احسن انسحاب مع رفع دعوة قضائية على جدهم قاع لانهم كلهم متواطئين	negative
مدامو موحد بالله ماكاش لي علابالو علاقتو كيفاه مع ربي \nماتكفروش الناس كيما تحبو\nالله يهديك	positive
السياح تاع تونس اغلبهم جزايريين وليبين وكما قلتي حنا الي حلينا ليهم العين بلادنا ماكاش خير منها…	positive
والله غير علابالي بلي متاهلتش	neutral
RT هذا يوم كانت العاصمة ... عاصمة ...و قبل ما يدخلها أمثال أنس تينا الذي بقي بعقلية الدشرة المعقدة رغم أنه ولد في العاصمة ...…	negative
الدفاع الدفاع وقتاش نهاجمو ؟؟	negative
جماعة كابتن ماجد اجبذو روحكم وسامحونا شوي\nعلابالي راكم تلعبوها أمام الناس انكم الجيل الذهبي\nههه الهدرة كامل مع (اله…	negative
ايه علابالي وانا درته علاجال ربي باينة ماشي علاجال الرايح والجاي	positive
قولي لون عيونك قهوي من الاول \nموش لما انجي في الشمس لونهم\nعسلي	negative
روح اجمع السليبات تاعكم امبعد احكي 🤣🤣🤣🤣🤣	negative
عقلية الاصنام..انهزاميين..ارحل...و خلي الكفاءة تخدم بلادها..شغل كي رقدت ساعة مزية منك	negative
في مصطلح القهوي (لي انا شخصيا جامي استعملتو) .. راكم تتناقشو على المصطلح مش على الظاهرة! \nحنا وعلاش دايما نركزو مع…	negative
جياحة و تفاهة. هذا خبر نبقاو نتبعوه و محبين و في التلفاز حاطين عاجل.... تفاهة	negative
وين علابالى دوك هك شوي مانلقاكش	negative
زعما زماكري	negative
عندي بزاف الله يهديني	negative
ونعم بك وباصلك يا خو شما	positive
ايه و الله ما علابالي . J des restrictions f profil ديالي ما علباليش و علاه 🤷🏻\u200d♀️	negative
نضحكو؟ الاغنية موجودة فسبوتيفاي كوك يعني استماعاتها منسوبة له ولا لازم تكون من البومو حتى تعت…	negative
سمعت الفيديو 😨 تبهليل ذا مش كرم	negative
والله بزاف خويا محمد.. \nمساء الخير خويا	positive
وعليكم سلام مرحبا بيك طولتي يابناة الناس 🙄😒	positive
بصح ياختي صمطناها بزاف،🌚🌚🌚🥴	negative
ياربييييي 😭😭😭ت تهبل سطيف تأمنو بالله اول مرة نشوفها هكذا \nمكانش علابالي بلي هي شابة قدنهاك 😭😭😭\nتقول بلاصة اوروبية ا…	positive
السلام عليكم مساء الخير سخانه بزاف الرطوبه	negative
الشباب ماراهوش يهربو من دزاير علاجال الدين باش يكون في علمك ونتي ادرى وا…	neutral
توحشت وحد لي سونتيمو علابالي منقدرش نوصفو باسكو راحلي من كنت صغير كان اسمو النية 💔	negative
واش هذا خويا أنور؟؟؟؟غابة متنقلة؟؟؟؟ههههه ربما كاش مسؤول جاي يدشن كاش حاجة هههههه 🤣	negative
علاش راكي مستورة ضرك	negative
😊 علابالي	positive
سقسيت بنت اختي عمرها16سنة\nوشنو هي الحاجة لي تخليني نقوي شخصيتي \nقالتلي دايما اتفكري بلي كاين ناس راهم يستناو وقتاش…	neutral
بالنسبالي راح مجرد خرطي مهما يعمل يظل في عيني فاشل ومادار والو وملف عقود ماقبل التشغيل يكفيه كبصمة عار…	negative
علابالي ربي يحفظك 🎩\nسوسبانس لآخر دقيقة 🤣🤣🤣	positive
تختلف عقليات هنا حسب المنطقة والسن يعني ماشي كي تختلف مع عبد تقول عليه قهوي وكعبة وتحس روحك هارب عليه ونتا مزالك في عالم ثالث	negative
حتى زوجته المسكينة عايشة في قصر في فرنسا شفتها غاضتني وبكيت ولتنساي ان ام زوجته يهودية الاصل	negative
اممم ما سمعتيش بيها\nراهي دايرة بزاف هنايا\nقهوي كاين الي قالك تقال على الكافي ولا المتخلف و كل واحد…	neutral
وكاين بزاف فرحانين بزيارته	negative
الغيرة تنطق الله غالب كي تشوف استقلال الجزائر وثورته وتشوف الوثيقة تاعكم تحس بالعار علابالي 😌🌶	negative
وله غير غاضني😢	negative
مفهمتش وعلاه لازم يحطوك تابع لكاش فرقة ولا منهج وبعدها يهاجموك	neutral
مسكينة عروستي 😿 ،واقيل راهي تخمم وقتاش عرسها	negative
ولاد لبلاد يا.. خو ههه	positive
يبعثولك يحكو معاك ، يضحكو ويقولو معريفة خير، من بعد يعطوك بلوك !!\nوالله حبيت نفهم علاش بعثتلي وعلاش بلو…	negative
ماشاء الله بصحتكم، وسبحان الله بدات تصب فيها بزاف؟	positive
كي نبعث حاجة كاش واحد و تفوت 5 ثواني و ميردش عليا\nأنا:	negative
مايتنفسوش واقيل عايشين قدرة \U0001f972	negative
😂😂😂😂😂😂صرعونا والله	negative
نقول كلمة حق\nاستاذة اصغر طفل في عايلتي في نهاية السنة وصاتهم قاتلهم خبوا ادواتكم من محفظة و مقلمة و غلا…	positive
بصح وقتاش نلقو حقل به 150 مليار برميل و نولو اغنياء	positive
نتفاهمو حاجة فالجزائر المراة لي تجهز البيت مش راجل ومتأكدة كل عندكم خواتاتكم تزوجو سقسي الاب ولا سقس…	positive
غاضتني حاجة هي اسم محمد راهم يجرجرو فيه بالعاني.\nالله المستعان	negative
من علامات قلة التربـية و الادب \n- شحال تخلص؟- مزال مجبتيش ذراري ؟؟-واشبيك قاعد عازب ولا قاعدة عازبة؟- واش بيك شينت…	negative
😋😂😂 سي هي مش حاجة كبيرة 🤭🤭\nايااا وكيفااه زعما باه نسرقوووه مديلنا المفتاح 😋😋😂😂😂	negative
الحب ماكاش كامل ديجا هي مجرد فكرة يجيبو بيها الوقت بيكم	negative
وعلاش تغبني في روحك	positive
وعلاش ماشي زعما؟	neutral
واقيلا طياب لكرعين بلحمص😂	negative
وي علابالي ، مي كي كتبتها لعشية ماكانش بريفي\nراني ندير كادنة كي مانكونش هنا و نحيها كي نجي	neutral
وتبقي الصور عبرة للاجيال القادمة دل كهذا ماكاش 😂😂	negative
علابالي ما فهمتنيش علاذيك وضحتلك هواري 😂😂😂😂😂😂	positive
انا وحد من الناس كنت في الجيش منكدبش عليك بصح الله غالب كون جيت قاري بزاف كون انا رتبة عال	negative
سقسي امك تعرف التاريخ خير من باباك	negative
😂😂 علابالي نعرفك	positive
معطيات مغلوطة🤔 و جدلا كانت ارقام صحيحة فهل ما قاموا به مزية😲 حاسيلو حسبنا الله و نعم الوكيل فيهم، صحة الرقعة ما تتنحاش🙄	negative
واش ماشي نفس الفريق !!!\nوعلاش نفس المدرب ؟	neutral
اخطونا ما تخلطوش في النجاسة فتجبروننا على شم اكره الروائح	negative
وعلاه تعب روحك وتروح للمرشي تقضي🤷\u200d♀️ كي ممنوع الاعتراض ؟؟؟ حط رجل على رجل وتشرط يا مول القضيان 🥺🙌😂😂	negative
حاب نسأل النساء سؤال حنا ليجان بربي ان شاء الله واحد مايقعد ونكملوها فالضفة الاخرى و لبلاد راي ليكم وريونا برك كيفا…	negative
اخطونا برك، بك بحكومتك بمسؤوليك	negative
صبت عندنا ، ضرك تلحق ليكم	positive
علابالي فهمت قصدي خويا يوسف ههههه هدي قاورية واقيل	negative
غاضني لحال منكذبش عليك	negative
اخي انا تاجر جملة علابالي واش راني نهدر ،مكاش سلعة راهي ندرة كبيرة في سوق ،منع استراد بدو…	negative
سطايفية خيار الناس	positive
الله يعطيهم الصحه والعافيه يارب العالمين	positive
مزية وريتلنا الطريقة ههههه	positive
🤣🤣🤣 حياتكم عذاب بالفوتوشوب ، شرعية يا خو🤣🤣🤣	negative
اه ما كنتش عارف اربع قاعات تكفي ل32منتخب ان شاء الله يخططو باش يقدمو مل…	neutral
صار هكا ، و الله ما علابالي	neutral
صفي أنت منهم وعلاه راك تسب	negative
ساعات نكتب تويتة في موضوع ما امبعد نقول علاش نعطي في رأيي في العام السماح موش لازم نولي نفسخها ونغرد مع مخي..القصد…	negative
الاعلامي!!!! حسيت جايب مارسيل غانم او نيشان....يا مسطول واحد ما دارس صحاف…	negative
ههههههههه مزية مش طفل اما راها غضبانة على اسم الدب	positive
😢😢💔💔والله غاضني مدرب في القمة ما يستاهلش هاد المعاملة	negative
المضحك قالك فيها ملف والله تبهديلة	negative
أنا جاهل منقراش عندي منحت البطالة و ضمان صحي الدواء بالمجان وعاطيتني الدولة…	negative
شعب الحجرة اعطيني ولاية وحدة راهي مجهزة رياضيا كيما وهران وين نلعبوها تندوف ؟؟؟؟؟	negative
اذا لم يتم تجنب الاستقبال الشعبي فأنا نقولك غير خاف وعاود ، لان عشاق خرنسا الفرانكفونيين بلا حساب وزيد…	negative
ما شفتش واش قالو بصح علابالي كي العام الي فات كي سنة كي عام الجاي حاجة ماراح تتبدل لوكان كانت عقوبا…	negative
على الاقل يعبرو و يتواصلو ماكاش إعاقة سلوكية	negative
علابالي كلمة تع ذر بصح\nwomen	negative
زكارة فيكم يا الطماعين	negative
مام صوتها فالاغاني شباب وفاللايف يكون شباب كثر روحي شوفي المتدربين ماكاش لي يجب النبرةنتاعها	positive
لا عنديش مزية\nاي نحن كشعب نستحقوش النظافة و النظام	negative
وعلاه تحوسي تبكيني جيلان 😭😭😭\nوانا بالكاد اتجاوز كل مغادر لدرجة انني لم اعود اعلم من انتظر عودته او سألوح…	negative
الارقام هاذو ماكاش منها راني نسيي ماكاش	negative
واقيلا 😂	neutral
وعلاه غير انا فيديوهاتي مايطلعوش 🙂💔\nاصلا هذا الفيديوا مراحش يطلع 🥺💔😫	negative
تفبلي بشيخك .؟\nزكارة في عجوزتك.؟\nقمة الحمق والتفاهة.؟	negative
زعنا زعما راكي تشوفي لي كومونتار توعنا ولا زاد ناقص	neutral
اسمحلي بصح وينها العنصرية هنا ؟	neutral
ههه مزية منيش وحدي	positive
خطرة خطرة روح سقسي علا روحك فى البلادية... 🙂🇩🇿🤣	neutral
وايييه ... تبهديلة و تبون فرحان 🥴🤦🏽\u200d♀️ ما كاينش النيف طار 😂😂	negative
ايه هذاك المرض يخليه يدير هكا \nبصح ماتوقعتهاش قع بلي اليوت المقرصن اللي يدور عليه المسلسل هو مجرد شخ…	negative
هاذي واش ماعلاباليش بروحي وش ديرت 😂😅 تخلاط لي بزاف مش مليح	negative
درڨ حسو ، واقيلا راه في نيودلهي ههههه	neutral
انا غاضني الحال درك ما غاضونيش نقولهالك خليهم كيما حنا ربي طفاها بشوية تع المطر يستغيثوه بالاك يشوف ليهم .	negative
لعيا.. شه بعدما سمعو لخبر الووو سيدنا واغير عتقنا خههه\nلاغاز لا صحرا لاسبته لامليليه لاوالو غاضتني غير هديك لحريره…	negative
ههههههه علابالي بلي عينك مش حارة 😏😊😌😌	positive
مرحبا بيك خويا	positive
مزية تفكرتونا	positive
RT توحشك يا ماكرون علاه تبدل عليا و انا عاطيك كلشي على زعما مدام تاعك بريجيت حسن مني انا را تبون نحبك بزاف و شباب عليها	negative
متعودة عليهم وماقدروليش وعلاه منعرف 😂😂😂	positive
سقسي روحك حمارة ومشكلة انا مقلتهاش ليك نتي قلتيها😂😂	negative
صرعونا بهاذ الموسيقى تع توم وجيري 😒\nاطلڤ اطلڤ ""طاحو ليجوندارم دارو لونكات آي مول الكارزان"" 🎶🎶\n\n#العاب_البحر_الابيض_المتوسط	negative
وقتاش يفرج ربي و ينحي الشك لي بيا	negative
صباح الخير ....بالصح كي تكون 65 سنة تلبس كيما هاك هاذا يتسمى تبهليل ...معليش تكون نظيف ومحسن وجهك…	negative
نيشان ، يكون دور الزوجة البيت هو ماشي تقليل من قيمة الزوجة على الإطلاق واش عرفتي شناهي تربي طفل(ة) و…	positive
الشعب الجزائري نائم وقتاش يفيقوا	negative
😂🤣 وعلاه دزاير ماترفض الزيارة تاعو \n\nمرحبا سيادة	neutral
مصطلح ""قهوي"" هو مصطلح عنصري و معناه اللون البني.. وهو إشارة إلى العرب باعتبارهم بشرتهم سمراء.. كل شخص يستعمله بقصد…	positive
علابالي … لذلك أغيضه ، أعلم جيدا ان عقدته من الجزائر أكبر بكثير من حب بلده	negative
زعما اي كومنتي 😂\U0001f972	neutral
وعلاه ماكاش السفر عن طريق البحر ؟ والحرقة فالبوطي كيفاش ؟	neutral
النفسية محتاجة زلة تهدر بزاف \nوتريبوندي بلخف 💔😩	negative
ايه علابالي , اما لي قدر مايراطيش حتى ولو صفحة كيف قلت او يقرى واش يحفظ ( سور . ايات )	positive
انا تاني نستيه الطيب ناس ملاح علابالي ربي يحفظك 🤗	positive
ليوم تقلقت بزاف هنا وعايبت اصدقاء هههه بصح في الحق ومانجرحش ابدا ..نظن يكرهوني ضك😌	negative
ههه مزية سلكتي	positive
انا ماسمعتش ان المواطنين قاعدين يساهم في اطفاء الحرايق.\nمهمة رجال الاطفاء والجيش. اش مدخلنا نحن ؟\nعقلية ! اللي يلقى…	negative
🤪انا غير قصدت لك زعما راه قديممممممممم يمكن قبل التسعينات	negative
ما تحشمش تزوخ بفريق كيمن هك على البرسا	negative
يخرجو عليك ، انتا شباب ماشي كيما انا قهوي 😭	negative
ديك محبوبة الملايين زعما	neutral
وعلاه... هذوك جاوك عباد كيما الناس، ياكلو الحنوشة، الفكارن، الخنافس..... وزيد وزيد	negative
مزية اديداس كانت تبعثلنا الشيفون تقول يصدقو علينا 😏	negative
و انا حابة نفهم انتي واش قلقك حنا حيوطة بيبان طواقي طرقات انت واش دخلك فيها و فينا متلعبوهاش زعما كلاس 🤫😉	negative
ما دخل اللون في تحلاب.. و محلاه الاشقر 😍	neutral
سقسي تعرف ..وارجع للعام لفات خطاب تبون وقت الحرائق تعرف دارو عقود شراء مع اسبانيا وروسيا ولالا…	neutral
🔴 علابالي متصدقونيش	negative
غاضني بونجاح للآن مرجعش لمستواه واذا كمل هكذا راحت بلاصته في ليكيب ناسيونال	negative
مسامح أخي علابالي بلي حنا دزيريين عندنا شوية تاع لافونز 🤣🤣	positive
والله مرة 1 د و مرة 5 د و مرة بوشونة تع كاش حاجة\n🤣🤣🤣🤣🤣🤣🤣ناس مراض	negative
عارفين ومعنداش شك فيك وعلاش العاقلة عندكم منسية	negative
و الإجابة قلتها لأنك بكيت\nو غاضني حالك يا أستاذة 🙏😂	negative
لا راني باشع بزاف منيش حاب تهربو من خلق ربي كي تشوفوني هدا مكان	negative
😂😂😂🤗علابالي هاني قلت	neutral
واقيلا حساباتها فتحتي la crèche 😂	negative
عاملة روحك ذكية بالله اسكت من وقتاش 50% في استفتاء ولا دولة تنجم	negative
سود الله وجوهكم يا خوNة	negative
راهم عايشين غاية يا خو برك.	positive
راح خالد جات ادي .. جياحة كبيرة و الله المستعان	negative
ياودي واش دخلك ؟؟ وعلاش تقف معاها نتايا	negative
اخطونا صحا	negative
هههه حقيقتنا الجزائريين \nماكاش تحلاب	negative
المسجد الأعظم قلك داروه زكارة في فرنسا 😁	negative
ياخي هذا مات وقتاش رجع من القامار🤭\n😅😅😅😅😅	negative
ماكاش للاسف 😐🤷	negative
زعما نوصل🤔	neutral
وعلاش احنا ملائكة ؟ حتى احنا نسب فيهم .	negative
مرنكة أقسم بالله 😂😂😂تبهليل ما بعد منتصف الليل	negative
علابالي جزائرية ربي يحفظك 👌👌👌🇩🇿🇩🇿🇩🇿🇩🇿🥰	positive
هاااا جيجلي باه نلقاك علي حدود جيجل 🔪 ههههه	negative
علابالي موحال تصرا في الجزائر	negative
وعلاه غير احترافي ؟؟ أصلا اعلامنا لا يرتقب لهاته الصفة..…	negative
ميسي من وقتاش راح لميلان؟	neutral
هاد بزاف فيها غي نتا	neutral
على الجزائر فات شحال من عرق وراصة وماننجمش نقول انا عربي خاطرش مانيش سور ومانقولش امازيغي مانيش سور تاني…	neutral
ههههه ايه دير فينا مزية 😂🤭	negative
حشم منهم بزاف 😂😂	neutral
تخيلي خوك ولا ابنك ولا باباك ولا واحد من عائلتك يبعث لوحدة في البريفي و تفضحو و تشهر بيه قدام ربي و ع…	negative
كي تعشق تولي تسمع الراي بلا مزية منك	positive
زعما علاش	neutral
عندها مع كلاشات نيشان	negative
اواه نكمل خير . مابقاش بزاف	positive
حرية تعبير رانا في بلاد الديمقراطية لا لا ...هو حر ونحن كجزائريين نستقبل الناس المحترمين ولي يحبونا من…	positive
😳😳😳😳علاه حسدتني 🤣🤣🤣\nمعجبتكش واقيل 🤣🤣🤣🤣	negative
هههه علابالي 😂😂	neutral
علابالي عليها هدرت \nريبيري كي عادت مرتو دزيرية سما بنتو حيزية😌 \nهادا يماه دزيرية سماتو مبابي 🥴\nماتحكمش واقيل🤣🤣	negative
الجزائر بقرة حلوب، ليس الا، القطب القوي لم تقلها حتى سنغفورة.النيف يا خو	positive
وعلاه ،هذا الحاله عليك	neutral
علابالي راك تقرعج كل يوم\nبصحتك التقرعيجة ✌️	negative
اعتقد ان تعليق عن رىيس دولة اخرى لاعلاقة له بك يعتبر وضاعة من شخص او تحلاب ب…	negative
مرحبا بيك النور في طلتك أميرة تسلمي ❤	positive
بطة وقتاش تبان نتائج البكالوريا عندكم ؟	neutral
شكون الحلاب فينا اللي بهدتةلتو في وجهو وقالتلو يا الحلاب ولا اللي راهو آمي…	negative
نلعبو لعبة شابة:👀\nكمونتي لي متريبونديش عليه حتى وحدة ولي ماريبونداش عليها حتى واحد لمدة 24h بصحتك فليكسي 500😁🔥\nصحاب زكارة بلعقل على زوالي🐸💔	neutral
ههههههه حلب البقر واجب هذا ماوش تحلاب يا بقرة وشبيك درتي لروحك حكاية وصدقتيها ابداي تروحي يا معزة	negative
RT بنزيمة بزاف	positive
غاضني الشيخ مسكين خرجتلو خلعة 😭	negative
حلمنا بزاف او نسينا ✨\nبلي كلش بل مكتوب😓💔	negative
كيفي اقسم بالله خاصة هذاك الي يكسر الباب بالطبطيب \nيحسبك قاعدة عند الباب تستني وقتاش يطبطب\nوالحديث قياس🤣😉	negative
واقيل داها فيك بليدي🤷🏻\u200d♀️	negative
علابالي وشفت من قريب ربي يهدي ما خلق ويشافي المرضى كامل	positive
😭😭😭😭😭😭😭😭😭😭😭😭😭😭😭😭علابالي شابة 😭	positive
وعلاش احنا قلنا مثقف أو يعطنا دروس ..... أو ذكرناه اصلا؟!	neutral
نيشان والله ،حابسين في عصر الجاهلية ، وفرحان بروحه وڨاع	negative
زعما قداش طلب فدية فيهم 😂😂	negative
هذا حنى نقلولو مطلوع \nسقسي \n	neutral
جياحة وقلت تربية \nربي يهدي	negative
متفقين على القهويين بصح ثاني صاحب الفيديو قهوي في كلش	negative
العمرة ساعتين والحج يوم واحد، تروح الصباح ترجع العشية\nوعلاش لا الأستاذة ممكن تساهم بأفكارها\nترقبي التغيير الحكومي ا…	positive
وعلاه الرجال ماعندهمش قلب والاحساس والضمير كي تبكي نقلك	negative
شكون تاني ؟	neutral
القصة هادي وين ندور نقراها\nواقيل كامل صراتلكم 🤔	neutral
راكي غايضتني بزاف علي بالك اي حقيقة تاريخية تقلبوها ع الاخرين ههههههخخ وانا مش كما انت	negative
لا عليك حبيبتي وعلاش غاتعصبي؟الخير داروليها الله.\nبالعكس،الحمد لله،ربما الله مخبي ليها كنوز من النعم❤	positive
عمبالك كون جيت فبلاصتك نقفل تويتر منزيدش نبان ، تبهديلة مور تبهديلة ووجك قاصح على صور الصين	negative
الا الإدارة لي نخدم فيها مرحبا بيك	positive
تحلاب برك واقيل 🤣🤣🤣	negative
علابالي بصح داير شويا النية	positive
ما شفتيش المقروط نتاعها والغريبية واش نقولك ماكاش كيفهم في المجرة ،نورمالمون كانو ينجبدو…	positive
البارح خويا 👦🏼الصغير دار صبعو في نيفو\nقالتلو ما ديرش صبعك في نيفك تنتفخ كرشك \nاليوم جات خالتي وكانت حامل \nخويا صغير…	neutral
تكتيكات البيس \nغاضتني كي شفتها دايرينها ضد اليونايتد 💔	negative
بعيد الشر عمري لا درتها حتى و شخص يعجبني و الله ما يسمعها مني منحبش.. ننحط في مواقف بيخة هههه... و علاب…	negative
نعاودها زكارة 😌😂	negative
اوي طيحيلهم برك 😂 امبعد خليهم هكك 😂😂😂	negative
هههههههههههههههه هاداك لي حاطه راه طلع وهدر واعتذر وزاوجة يا…	negative
جامي حشمت ف تويتر كيما ضرك 😭😭😭	negative
واه نيشان تزيدهم في دارها ولا تعيش بيهم هي وياه خير ، الناس ما يبغولكش الخير إلا والديك وخوتك ، تتهلي في…	negative
العمر مش مشكلة اما المفروض العمر يعني خبرة\nيعني تولي تعرف وقتاش تكمل او توقف و تسيب لغيرك كيما يعني تعرف تحدد شكون يضر فيك	neutral
عادي خويا اسحاق علابالي بلي مافهمتنيش\nمكان حتى مشكل	positive
وقتاش تكملو الديوان ؟ ❤️❤️❤️	positive
يبحثو برك ِ.ِِ مايلقاوش .ِ. نص لكبير يعيش قليل .. و يتفرج كاش حاجة فليل ( النهار ولا )\nو يرقد على19:15	negative
بقاو فيا غير هاذوك للي غشوا ف الإمتحانات الباكالوريا وحبسوهم ف لحباسات قد تصل مدة السجن إلى خمس سنوات وعلاش زعمة ما…	negative
وش يستفيد واحد من البلد كي يتزعز الاستقار يعني يقبلو يقتلو عاىلات نورمال؟ علابالي…	negative
يا خو الجزائر باموال الغاز لم تستطيع ان تشتري طائرات لاطفاء الحرائق وتركت الشعب يموت…	negative
سقسي السي بالماضي اذا يقبل	neutral
واقيلا حتى أنا مشيت فيها	neutral
اواه، لا لا، ماشكيتش، ماكاش منها، موحال	neutral
وهل من يقطن العاصمة كلهم ابناء العاصمة\nالاغلبية دخلوا من دشرة\nواستقروا بها\nاذا كلمة قهوي معناها kavi…	negative
اااه شكرا لأخ مكانش علابالي 💙🤍	positive
ايه والله صح علابالي ام يخرجولي ديما و نعيى نفهم شكون لي يتابع فيهم	negative
زنقه كلها 🤣واقيلا تتشبه لعيون ماكرون حب قلبهم🤣🤣🤣🤣	negative
زعما يعيش أكثر من الشباب🤣	neutral
اللهم آمين يارب 🤲\nايه قاتلي ختي واقيل من بحر ولاكليم	positive
وعلاش الي يمشي لل بحر يلم وسخو وراه ولي في شارع ميلوحش وسخو وعلاش يلزم فما شكون ينظف وراه؟	negative
وعلاه مالا تعلقو على التغريدات التي فيها اسم الجزائر؟؟ معقدين ؟ هاذا هو طبعكم يالعياشة و هاذا الي تعرفو 😎	negative
😂😂😂 راه جابها ليه نيشان فالمؤتمر الصحفي قال ليه حنا جينا هنا باش نهضروا كيفاش نتصرفو…	neutral
وقتاش، يكون فالسبوتيفاي	neutral
سقسي الريسيفسر الي حطها ثم اخطاك من الحشمة😏😤	negative
هاد ليام حتى اسفي مفيهش قليل بزاف	negative
نيشان ولا لا 😅😅😅؟؟	neutral
كتروا بزاف كل عفسة يدربوا فيها نصف ساعة اوركسترا قريب ساعة و دوك هدرة ما حبوش يسكتوا normalement thank you و السلام عليكم	negative
🤭🤭🤭 يستحيو زعما	negative
واقيلا يلا حنا بزاف ههه ❤️❤️✌🏻	positive
هههههههع عجبوني بزاف. براف	positive
و انت كي تقطع طريق كاش واحد دار فيك مزية؟\nكاين القانون يقولك وين تقطع وقتاش عندك الأولوية، ا…	negative
سقسي تبون لقالهم اروحو	neutral
ادعو إخواني 🇩🇿 الى دعم الرئيس، زكارة في المروك 💪🏼	negative
RT ساعات نكتب تويتة في موضوع ما امبعد نقول علاش نعطي في رأيي في العام السماح موش لازم نولي نفسخها ونغرد مع مخي..القصد أنو…	negative
الضرسة حيدتها وعلاش الحراق باقي فضرسة الي حداها 😭😭😭	negative
علابالي اختي جازية 😘 والله نفس الشي راكي من اعز البنات عندي ... ربي يهنيك و يسعدك و يطمن قلبك ❤	positive
في عاصمة يفرحوك دوك يخرجو لي فرنكوفون ماتخافيش تبهديلة فيها فيها	negative
و ترويج تع mvs واش 🙂. ماعلاباليش المهم دايما نشوفهم يروجوا في خارج من دعوات كونسرات	neutral
ماشاء الله عليكم نسال الله لكم الرزق الحلال الطيب المبارك و الذرية الصالحة و رضاء الوالدين .و بصفت…	positive
نيشان ونشدو حتى طريق المطار مالو يخلعنا😂😂	positive
كوكب اكشن زعما 🤭😭😂	negative
غاضني العداد تاعو راح يحبس في 18 لقب 💔	negative
ههههه بلا مزية	positive
وقتاش برك يخرج الصيف خلي نهاري يتبدل شوي ...	neutral
RT ربي يرحم لي ماتو و يطفي النيران\nو تطفى معاها الفرفارة تاع واحد القوم\nتسمعهم يحكو في ليتسع تقول من أشد منا قوة\nو وقت الصح ش…	positive
- وعلاش راك لابس هذي لبسة ؟-مزال مادرتش التاويل ؟ -واش شريت؟\nربي يهدي ما خلق 🤲\n\nمنقول	negative
بزاف عليه	neutral
شكرا على المعلومة ما كنتش علابالي	positive
الله يسلمك ماعلاباليش وين راها المشكلة بصح تعليقاتك ما يخرجوليش تم تم 🤔	negative
تقبيل الأجداد!؟ قصدك الحركى يحبون من يدفع لهم باليورو لخيانة دولته 😆😆😆😆 مسكين غاضك الح…	negative
وعلاه جاى مكرون	neutral
مرحبا بيك.. يتوحشك الخير حبوبة❤️	positive
مزية الدار داري و داركم🤣🤣🤣🤣🤣	positive
شحال تحزقو....	negative
علابالي بلي نهدر بزاف بصح منسمحش ليك تقول لي كذا و تهيني	negative
الاتراااك يكرهووو العرب وقتاش تفهموها هادي	negative
الله يبارك دقة عالية فالكانون نيشان 🤭\nأمسيتك طيبة ولد ما ❤️🇩🇿	positive
ماكاش مبهدلين قدكم نهاركم كامل نباح ف نباح	negative
ولكن رتبتك العالية راح تضر بزاف ناس لهما الشعب	negative
هههه علابالي صعيب و يغيضكم الحال ماشي ماتقدرش تشرح أولا \nث…	negative
وعلاه هابلين ملا يتزوجو موظفات ؟؟!!!\nناس مرضى	negative
سقسي يس\nانا منعرفوش ههه	neutral
علابالي بلي فهمت مليح. و قاع رانا فاهمين لكن لا نناقض بعضنا	positive
نيشان بصح هذا العام مرڨوها	negative
اخطونا برك	negative
وايييييه 😤😤😤 ما عرفتش وقتاش يوليو عندنا الاشخاص المناسبين في الاماكن المناسبة فبلاصة هاد الهواة	negative
وعلاه كاين لبحر في تبسة وانا معلاباليش	neutral
نتي نجمة فالسماء ضاوية وقلوب الناس ناسية\nيشمعة وعلاش طافية🚫😞	negative
هي امور تقرقرشت انت مواضيع المهم \nوصفية و خللين ملكية قاموس عند أفراد بيننا أقل ربما \nلكن انت لازم تلخص ما سلاح يظه…	negative
ماكاش الغاز يا الله روحو تطلبو بعيد ما فيهاش و شكرا	negative
مزية لي خبرتونا دوك ندو سني بقلاوة ونروحو نحمدوا 😐	positive
راك تهدر على هذاك لي داير حساب امريكي ومسميه كولن واقيل	neutral
والله ما علابالي ههههههه\nواقيلا يتبحرو 😂😂😂😂	negative
والله يضحكوني الاغاني تع الوقت هذا هههههه فاتت سيارة مداير الغناء صوت عالي و الأغنية وش تقول والله زوج كلمات حتى ال…	positive
هاد جمهور أرسنال واقيلا ملقا ميقول من غير تيكيلا\n#premiereleagu	negative
مسلسل اسمعني واقيل غير انا لي ماسمعتش بيه🤔	neutral
راني نقولك ، لدي الطفلة و هوما ما تحلاب ما يجوك ما تروح عندهم	negative
بززززززاف	neutral
آو من وقتاش هاذ الشي انا ما علاباليش	neutral
لي غاضتني مين طعن و شبهه يزيد بن معاوية ابن أبي سفيان رضي الله عنهم\n😢	negative
مزال مفهمتش وعلاه تسالني متين الف🤔وقتاش ديتها عليك🙄	negative
مزية مطحتش في أسما 😒😒😂😂💃🏻💃🏻💃🏻	positive
في باغي؟يا خو مكاش منها!!	neutral
يحرق الراسة نتاعههم لا اهلا ولا سهلا يخي حنا ماشي امة علاش يجي ماجانا حتى خير من جهتهم يا جماعة قال…	negative
امال اتو انقوللها وقتاش تعوم 😂	neutral
ههههه مزية قلتيلنا باه الواحد ميغلطش	positive
اختي حرة و نص علابالي 😉😅	positive
يا خو صحبي	neutral
اخطونا من الحب والخراطي ركبتو في \nبرويطة ولا جامي 😂❤️✅	negative
واقيل راني نعيي فيك سامحيني سامحيني على الازعاج، أنا ما عنديش الزهر معاك.	negative
واش بيك يا خو بلعقل قدر الله ماشء فعل ولل الضحايا ربي يعطيهم الصبر انا للاه وان اليه راجعون انهم شهداء	positive
وكان علابالي نقولك دعيلي بالشفاء \nراني قريب نقيبس\nمتنساش تجي تعزي 😁😁	negative
وعلاه الزحف يا وليدي، كرعيهم مقطوعين 🤔🤔	negative
سقسي المانيا تقولك 🤣	neutral
يكون شرب فونتا تفاح صح زعما	neutral
RT بشنو قاعد يقنع فيها زعما ؟🤔	negative
غاضني مسكين	negative
زعما باغيين ينسّونا فالموضوع ياو فاقوا هههه	negative
ماكاش اسرع مني 🌚🤞\nهيا قاع فليكومونتار نشوفو اسرع واحد نطلعو 🙃💞	neutral
ايه حتا و أنا قلت هاذي تبقى مسألة شخصية ، كلها و كيفاش و وقتاش و الطريقة لي تساعدك الزواج بصفة عامة مسألة نسبية و كلها و مكتوبه	neutral
وعلاه يتعب روحو اسيدي	negative
الخوف يا خو 😂😂😂	negative
نبعثولك تشوفو امبعد	neutral
وشعبك وقتاش توقف معاه كيما راك واقف مع توتس وفلسطين	negative
علابالي وااه...ما نسيتش	neutral
ديرها علابالي 😂😂😂😂	neutral
علابالي و شفت الاصلي بصح يهمني واش تهدر فالفيديو	neutral
زعما كون مدلو ليفري ترجع أخلاقية؟؟	negative
صحابي نهار كامل يشكو معندهمش الزهر \nواقيل نساو بلي عندهم أنا	positive
على اريك في مسلسل the walkinge daed قتله نيغن الحلوف غاضني والله حتى بكيت هههههه	negative
مول الإقامة لي نقص واقيلا	neutral
الحمد لله و أخيرا رايحين يديرو عفسة في جيجل\n ولاية همشوها تهميش كبير و هي جوهرة الشرق، من الأجمل على خط الساحلي للجزائر 🇩🇿❤️	positive
هدوء متاع واد ساكت ما تعرفش وقتاش يفيض 🤣	negative
القهوي هو الإنسان الذي يصف غيره بها \nواحد لابس لباس متواضع قهوي\nواحد من خارج الولاية قهوي \nواحد يسكن…	positive
ماكاش خيانة قد الخيانة تاع كي صحابك يحولوا للبحر و مايحلبوكش 😩💔	negative
شفت بأه مرة وحدخرا ما تاكل اليد الي تعاون فيك. علابالي الجزائر قلبها حنين و راح تعاونهم	positive
علابالي قبل الاتفاقيات ف الاسلام لا يجوز حتى نبش قبور النصارى \nانا نتكلم على ناس ل زادت فيها هم…	positive
ماغضتنيش كي راني سلبتار..... \nغاضتني كي راهم حاسبيني ان كوبل 💔🙃	negative
ما نشفالهاش مليح .\nو التيلي الاول شريناه واقيلا في 92 ، كان قاتلنا الفقر ههههه	negative
مش غير غريبة والاكثر غرابة التصاور جايين من تلفونها😂😂😂😂ماعلاباليش وش المغزا منهم	negative
استغنينا عن خدمتكم....اخطونا	negative
وااش يا خو 😂😂	neutral
و هي لاه تزوخ عليه و علابلها ما يشوفش 😒😂	negative
علابالي .. جاوبني على السؤال هذا	neutral
انا مزرتهاش و علابالي كيفاش كيما بجاية ناس عمبالهم لبحر الخ هما ماشافوش الزبل طروطوارات مكسرين العمران كارثي الخ	negative
لقد تم قطع دابر كاش حاجة	negative
ههههه بزاف	neutral
علابالي علابالي 😅😂😂\nربي يحفظك حبيبتي 🥰😘❤️	positive
واقيلا كنتي حاضرة؟ ياك	negative
كون غير يعتزلو جياحة بعد خرجة حبوس	negative
والله غاضتني ملقيتش حتى وش نقولها و طفل متصورش قد واش يهبل ربي يبارك و صغير عام برك ربي يعوضها	negative
😂😂😂علابالي مخك مؤثر فيه الحشيش متفهمش	negative
وعلاه هذا تشوف فيه جارية انت	negative
غاضتني الدابة مسكينة واش ذنبها باه يصرالها كيما هك اما أنتم الله لا ينفس عليكم حابين الذل وراضيين بيه…	negative
لي حيرني اكثر في هاذ الصورة و التقليعة : هل المسؤولين الكهول يشوفو و يتبعو واش يقولو عليهم في مواقع التواصل و ما حش…	negative
يسمى كاينة غير وهران ذرك 🤔🤔🤔\nها انعلو ابليس ،مازالنا في سياسة الإقصاء 😞😞😞	negative
مرحبا بيهم في جامعة تلمسان 😅	positive
تعوم في البحر راك تفوسختي نيشان ومنها تشد لوين ذهبي جميل	positive
يامول الصفحة وعلاه ماديرش تغريدة فيها اعانة من جميع الولايات يعونونة راه شي لا اله الا الله رانا جزا…	positive
أنا رايح جاي على تركيا بحكم بعض الأعمال و أقول لكم أبعد عن الشر و غنيله. \nبإختصار يكرهو حاجة اسمها ع…	negative
اممم باهية والصورة على اليسار من جيجل خلاف ؟	positive
يا ربي وقتاش يوفر لغاز	neutral
وزير الاوقاف واقيلا	neutral
مسكين حنين بزا	positive
عشت تجربتك هاذي انا بعد ماتوفى بابا لافامي نتاع ماما دارو كراعهم عندنا عايشيين عندنا من بعد خرجتلهم للعيب ن…	negative
😍😍😍😍😍😍😍 صعيبة يا راضية خاطيني تبارك الله عليك يا بنت سطيف شاطرة	positive
ماعندهم حتى سبب ميقبلوش عليه نورمالمو بصح على حسب علمي تقراي وين راكي اومبعد تحولي و زيدي سقسي…	neutral
فيلم هندي ... كيما فيلم النوفمبرية الباديسية امبعد خبطوهم بدستور يدعم خرافة اللغة الثانية	negative
لاا نيشان هادا الهدوء لي قبل العاصفة 😂😂	neutral
صباح الخير من سطيف العالي	positive
حنا مكنسواوس حنا كنس قبيح خصنا نديرو حملة نوقفو ها النية الزايدة نورو المشارقة كلهم أننا حبسنا الكرم والنية والضياف…	negative
كي نبدا نحكي ماكاش ليسكتني وكي نبطل نحكي مكاش لينطقني خاصة إذا كنت في حالة غضب ههه	neutral
ايه علابالي قوي كنت حابة منتخب أقوى 😂	positive
واقيلا على الربعة	neutral
على سلامتك أختي الكريمة ان شاء الله تكون بخير مرحبا بيك صباح الخير	positive
الجزائري:🇩🇿\nتقولو اطيني كاش حاجة ميمدلكش ❌\nكي تسرقو يقولك لوكان قتلي نمدلك 💔😂	negative
التنظيم زعما غادي يكون فمستوى عالي كما كان عليه في دورة وهران الالعاب المتوسطية 2022 ؟ 😅…	neutral
الحمد الله جاء واحد قال الحقيقة للاسف احنا في عنابة مناش عارفين وعلاه الدولة مهمشتنا بهذي الطريقة حتي…	positive
تسمعي بكريستيانو و كاسيميرو لي عندهم 5 أبطال .. و فاران لي عندو 4\nما رانيش نزوخ عليك بصح أنا هو الكابيتان ديالهم\nال…	positive
كلكم خرطي	negative
وعلاه متابعتنيش	negative
ناقصين بزاف تربية إلا من رحم ربك	negative
الجي فخونساز؟! تسما لي يهدر ويتقن اللغة الفرنسية ترجعوه الافخونساز \nواش هادي الهدرة عيب عليكم علاه الحقد هدا جياحة…	negative
وقتاش. العرس.....متبرع.....بكرهبتي. نوصلك ألا حد دار عريسك.🤣🤣🤣🤣	positive
هههههه مزية ماقريتيش معاك 😅	positive
مستفزين ،كي ناس الصحرا يشوفو كلامهم كيفاش ؟ وقتاش يتعلمو يحترمو ثقافات الاخرين.وزيد جهلهم كبير ما علابا…	negative
واقيلا بدا يصفي ف الحسابات	negative
سليماني في ليستر 😆 محرز الى مان سيتي🛫 \nسليماني في بريست 🙂 بلايلي إلى اين 🌚 \nباغي زعما 😆😆😆🇩🇿	neutral
تصور واقيل انتي هذي 🤣🤣🤣🤣🤣🤣🤣	negative
لا نرحب بالعدو الفرنسي اخطونا ايها المجرومون . ايها السلطة ما نسمح لكم باي علاقة مع العدو الدارك ماضي و…	negative
مزية راك حي ههه	positive
هاذي تبهليل ماشي فهامة	negative
الله يسلمك رؤوف. وقتاش المرواح؟	positive
اوك حبيت نقولك ماما صاحبة الميدان من قبلللك وبزااف حاربت لدرجة استقالت وهاجرت علابالي ب كلش رشاوى +ساب…	negative
وعلاه مازل الخير في امة العربي البشير احسني نيتك ترزقي عليها	positive
مهجورة منسية واقيلا هادشي لي فراسي	negative
هي نيشان 🤎🤎	positive
راح طيح weekend باش حتى الغاشي ميكونش بزاف، يكونو alaise.	positive
شفته هنايا اذا عاودت تلاقيت بيه نبعثهولك\nحتى بعدوهم الحراس و بعدها باش بدات هذي تاع وان تو…	neutral
حتى انا توحشتك بزاف يا بقرة 😔🤍	negative
ههههه كل يوم موش، ساهل\nوعلاه ما نقصوش في الدرجة 😅	negative
وعلاش البنات يعيشو كثر من الاولاد؟؟؟	neutral
بعيد شر وعلاه وعلاه	positive
علاه ماجاش اذا ؟! هههههههههههههههههههههههههههههههههههههه\n\nعلابالي غاضتكم عمركم على سيادكم الجدد القدم	negative
مالڨري داير بزاف غلطات في حياتي\nبصح جامي توحشت نولي نقرا🥱💔	negative
واقيلا حبو يقدملك نشرة الثامنة	negative
مزية استرجعت حسابك مرحبا بيك صديقي	positive
الأسئلة العلمية فرطو في كاش حاجة ؟	neutral
حاجة باينة حوايج بزاف	neutral
ان هنا اخبط، ونخبط،\nعلابالي،بلي،نعيييييييك	negative
الحمدلله كي فقتي روحك هبلتي 🤣🤣🤣🤣مرحبا بيك في مستشفى 🏥المجانين 🤣🤣🤣🤣	negative
شكون أنت؟ \nأنا هو لي دايما قاعد و معنديش الوقت🤦🏻\u200d♂️	neutral
هبال و الله، لكان ماشي غاضتني طفلة وحدة عند والديها مكاش معامن تروح و الله ما نروح	negative
و انتم عندكم التجهيزات كيما ذاك النهار كانت عندكم الحرائق ملقيتوش باش طفوها نهار كام…	negative
تصور يقلك اش عاملة فيك السخانة وطول يقلك وقتاش نفرحو بيك 🙈انا نلكمه طول👊👊👊🤣🤣🤣	negative
علابالي تبغو لي ي.ذلك.م	negative
ههههههه مزية الموضة تبدلت 😁😁🤭	positive
نعم اكيد آية علابالي	positive
الجزائر غير متضامنة معكم اخطونا	negative
صباح النور والسرور ⚘\nوبونجور عليكم توجور ☕\nبالعسل والكونفيتور\U0001f9c9\nنحبو بزاف دقلة نور 🌴\nولا داعي يا إسحاق للياجور😁	positive
في دزاير ماكاش تخطيط للمستقبل، نوض من رقاد شوف الأمور وين راهي رايحة وتبعها	negative
وعلاه حنا عندنا منتخب عالمي ..أسهل فرصة للتأهل ضيعناها برعونة المدرب وبعض اللاعبين	negative
ههههههههه وعلاه خيرتنا حنا 🙄\nاللطف ان شاء الله بردا وسلاما \nوزيد اوموا قول رتل الجلفة البرج المدية ...	positive
هذا وين علابالي 😂😂😂😂	positive
لا والله غير لا ههههه هاني نقولك الواقع المعاش\n\nمثلا تلقا واحد 40 سنة مزالو بلاكوست ولاريني ويدور…	neutral
واقيل انا تاني نشري واحد 🤔🤔🤔واش قولك	neutral
وعلاش راكي مقلقا	negative
يدير مزيه	negative
أمبعد تلقاهم يضحكو	neutral
باينين لي راح يستقبلوه زكارة فينا وجوه التبهدايل	negative
وعلاش راك في السعودية !	neutral
و انت واش دخلك 😒واقيلا يخرجو من جيبك	negative
احكي بالادلة متحكيش من راسك بلا ماتقراي تاريخك مزور المنهوب من كل بلد واذا عندكم راجل وا…	negative
حابة نعرف هاذو وينتا كان عندهم رأي و علاش ماسمعناش بأراءهم و وقتاش مثلو الشعب ؟؟؟؟	negative
حلال عليكم و حرام علينا زعما	negative
مزال مبديتش 😂😂😂✌🏻✌🏻✌🏻 علابالي ملف حافل بسلامتي ههههههه	positive
اختي حنا هنا ندعموك بكل شيء نخلوك تقعدى معانا في تويتر وتضحكي تاني علابالي فيه كثير مراض ومغرورين في ت…	positive
مزية جيت نفهم شوية فرنسيسة باش نتمتع فتعليقات الفرنسيس ما عجبهمش الحال هههه هههه تحبو على بيان	positive
يا اخي العزيز، انا والله ما كنت حاب نحط هذ المنشور، وما نحب نتسبب في مشكل ا…	positive
شفت فالفياضانات بزاف و لكن هادا راه الطوفان	negative
مزية لي راكي تستعرفي وماخسرتيش كاش زوالي مسكيين	positive
ايا مزية سمعت خبر شباب خسارة عليك معرضتنيش وعدتني	positive
ولادي 🙃🌚 جبتيهم نتي واقيل	negative
😭😭😭😭😂😂😂😂 علابالي بلي تمسخر بصح هذي لالا	negative
زعما كتبتيهم راني عارف وانت عارفة 😂😂😂	neutral
من غير مزيه أخي كامل بورك فيك أخا طيبا كريما	positive
وعلاش تحكي معه من الاول اصلا	negative
🟦👈في المخابز خبز عادي= لا يوجد\n\nخبز محسن=خبز عادي+ اربع حبات سينوج (15دج) مدة الصلاحية نصف ساعة و أمبعد يتكل بالمهر…	negative
للأسف شديد كاين لي ميعرفوش وقتاش تبدأ سنة الهجرية	negative
عجبتني تاع مرض بالكوفيد 🤣🤣🤣🤣\nانا كنت علابالي بلي الجزائر ماراحش تقبل و ماراحش يدخل ليها. هوما برك كانو يحمو في البندري وحدهم	negative
الصوره عاديه وقلتيهالي في العام والله غاضتني	negative
يخدمو ما يهدروش بزاف،تخية لواد سوف	positive
ياجماعة واقيلا هاذ هو الزحف لي قال عليه الريسوني ؟ ردو بالكم واعر	negative
أنا نعتذر لنفسي كانت لحظة غضب كي قررت نناقش وانا علابالي استنزاف للطاقة لا اكثر	negative
مام زكارة وتبقى مكراشة ،😑😑	negative
عندي بزاف متابعين مبلوكيتهم اذا حبت نعطيهم لها 😁	negative
🤣🤣🤣🤣🤣زعما مديريش 😜😜😜😜\nجمال طبيعي 😍😍😍	negative
مزال بعيد بزاف باش يكون افضل مدافع في الدوري	negative
الله يستر و خلاص \nماهوش ناقصنا تبهديل 😬	negative
ربي قال : المال و البنون زينة الحياة الدنيا\nامبعد يجيك واحد غليط يقولك الدراهم زبل الدنيا	negative
نيشان، هوما يتغطاو بالفصحى وهو يسب بالدارجة ديركت هذا وجه الاختلاف.	negative
صباح الخير جدة\nصدقتي والله ،ساعات نقول وعلاه مانتلاقاوش بالمثاليين هادو فالعالم الواقعي	positive
شرفك بزاااف عندك 28 و بلاا ما تبقى تكذب علينا زعما راني شارف	negative
واقيلا يطلقوه براءة مع العصابة	negative
غاضني مسكين 😥	negative
زعما كل بنادم غدار شكون لمليح في دنيا هذه	positive
الي يتمشى نيشان مع ربي ما يصرالهش هاك\nبالعكس ربي دايما يبارك في الحاجة الحلالية و لي كون في عون خوه	positive
تحلالك الدنيا ، مين يموت قلبك يعني : \nلازم تخسر كاش حاجة باه تعيش مليح ملازمش يكون عندك كلش✌️😉	negative
😂😂😂😂😂 طولتي بزاف ههه	negative
مسلخير وحنا زعما معريفة قديمة	positive
صح عيدك ينعاد عليك وعلى أهلك بالصحة والعافية وتقبل الله منا ومنكم صالح الأعمال \nحسبتها حاجة اخرى\nمن وهران ،اي ارواحي مرحبا بيك	positive
مرات يكونو دموع تماسيح 😂\nاما في حاجات بزاف لحقاتو ههههه	negative
مجتمع لا يقبل الاختلاف❗️بالسيف يحبونا طوابع سكر \nوقتاش نفهم أن لا أحد يملك الحقيقة المطلقة \nوأنها غير موجودة أصلا	negative
هههه ما تحمليهش هو كامل واقيل 😂😂😂	negative
RT وعلاه تحوسي تبكيني جيلان 😭😭😭\nوانا بالكاد اتجاوز كل مغادر لدرجة انني لم اعود اعلم من انتظر عودته او سألوح بكف ال…	negative
ههههه جات علابالي لما نشرتها	neutral
أين الهلال الأحمر الجزائري !!؟\n\nقيلولة واقيلا !!	negative
وعلاه ماتخرجوش النساء لي درتهم يخدموا في الحماية ومحافظة الغابات؟ حسبي الله ونعم الوكيل	negative
من وقتاش رجعت الجزاير عزيزة هاك	positive
ي الله تفضل قولنا شكون يا طوقوموري ما تخليهاش في قلبلك علابالي راهي تاكل فيك ماكلة	negative
ههههه وعلاه تضحكو اني طلعت ندير دورة برك و نولي	neutral
أكيد سهام فقط أنت من بلعباس أو تلمسان	neutral
ونستنى فيك يالعمر وقتاش تجي ؟ 🕰	negative
😂😂حتى الريجيم مزيان يا خو	positive
نتي مكيش تسمعي القران في الجوامع الجمعة زعما؟؟ لم اتكلم معك و كل واحد يحكم قدرو من فضلك	negative
وعلاش انتي تفكري في هذا كله 🤣	neutral
واش لي سرقوه ماشي بزاف خلي الناس ذوق الملح لو كان كمل مزيتو لحقها فوق ٤٠	negative
بصح الجزائر امازيغية كيفاش تجمع العرب ههههه .\nغرد كأنك كاش حاجة 😂😜😜	negative
وعلاش متزوجاته ع خاطر عضلاته ؟ طبيعي تنسجم مع الاحداث المتغيرة	negative
من الوقفة بزاف	positive
ايه هاذا واش كنت حايب نقول بهاد القاعات لقديمة ماراحش يع…	neutral
اخطونا من الحب و الخرطي ركبتو فالبرويطة ولا جامي !🤣	negative
امبعد علي ناس كلهم معش عندي خلوق لاحد	negative
القذافي كان مهموم بالزعامة العربية امبعد توجه للأفارقة..هذا مهموم بالهدم	negative
ههههههههههههههههههههههه مسكين 😭😭😃 كل واحد يمثل نفسو يا غامل	negative
قالك المروك زكارة فالامارات رايح يبعث سفيرة لطهران	negative
سقسي ماتخليهش في خاطرك	positive
ياطفلة غاضوني والديك على الاقل احشمي على اصلك واحشمي ع…	negative
زعما هو مريض ويمشي يسكر برا عادي بهاذ الطريقة😏😏	negative
هاذو الي تحبونا مانبكيوش عليهم\nونمجدو النظام زكارة فلي ذكرتهم\nعذر أقبح من ذنب\nالناس في العالم بأسره…	negative
داك النيف عليها واقيلا مادامتك يا الحلاب	negative
وقتاش مش تبدى حملة مقاطعة #الجزائر 😂😂😂	neutral
علابالي يا المازدا هاذو ليام ما راكش ترڨد و الخلعة راهي حاكماتك	negative
زعما يحب يهدر معانا غير بالكلام لي نحبوه حنا الجزائريين ولي هو كرة القدم! \nأصلا مكان مادخل السياسة في الرياضة	negative
مزية اعترفوا بلي حنا نرفضوا وعندما مواقف مش مذلولين كيفهم ههههههه	negative
يديروها يديروها كاين الحركة بزاف	negative
علابالي مهمش أوروبا ولا امريكا	neutral
مساء الخير مرحبا بيك في الغرب الجزائري ولاية غليزان	positive
بلا مانقراها علابالي واش كتبت	neutral
انا من متابعك نستنا وقتاش نلق فرصة ندردش معاك	positive
السلام عليكم وعلاش ما كانش منها	neutral
ههههه علابالي	neutral
صباح النور \nنشوفو وقتاش انحبسو انا وياك 😆	positive
وعلاه كان ميت بالسعادة؟	neutral
ولابد هههه ماكاش الهربة هههههه	positive
كي يلقاو إنسان نية يلعبو بيه حتى يكرهو ، منبعد يقولك وعلاه مبقاتش النية فالبلاد	negative
ماكاش لي يعاونك؟ 🙂	neutral
غاضني مسكين 💔😆	negative
اخطونا من جد السياسه الي فينا اكفينا\nكانت تغريدات تاع ضحك وغزل	negative
يعطيك الصحة، مزية منيش غالط 😅	positive
على واش يكون يحوس زعما ؟	negative
البكي بزاف اليوم واش صرا 😂🤔	negative
- يا راهي لاهية واقيلا عشق جديد...🤔🤔	negative
لا فرق في العنصرية بين قهوي يطلق على العربي أو بلغاري يطلق على القبايلي … و كلاهما مصطلحين خبيثين و نفس المخبر من يروج لهما	positive
وقتاش قالها هاذي خويا ..هاذي قديمة ..اضن الان راه بين الموت و الحياة	negative
🤣مزال واقيلا هيه	neutral
حابه نحللها علابالي مش راح طول 😭😭😭😭😭😭😭😭😭😭😭😭😭😭😭😭	negative
وعلاه وهران وش عندهم وجوه الشر هاذو في وهران.	negative
لا فرق في العنصرية بين قهوي يطلق على العربي أو بلغاري يطلق على القبايلي … و كلاهما مصطلحين خبيثين و نفس المخبر من يروج لهما	positive
وعلاه جيناك علي العين العورة حنا 🙄🙄🙄🙄🙄	negative
متكونش نسيت بلي بجاية خاصة جهة الشرق تقدر تزيدها مع سطيف	neutral
😂😂 هاذي كل غيرة من إسمي 😌😌😌 أحم خليه هكذا زكارة 😎😎	negative
هذا الشخص ومن معه هل يمكن أن نسميه ""قهوي""؟ \nإذا كان نعم، فهل التسمية نسبةً لِلونِه أم لِفِعلِه؟\n.	neutral
يخيا اهم شى لونه قهوي😭😭😭😭🤎	negative
راك ف مرحلة التدخين العشوائي 😔 بلا حساب واقيل ؟	negative
بالفرحة و السرور.طيبة كما أنت ندعموك بدون مقابل و بلا مزية.الله يسعد أوقاتك.	positive
غاضتني حالتك سوف أدرف معك القليل من الدموع 😂😂😂😂	negative
والله غاضني كي باعوه على الأقل إعاره او يحطو بند احقية الإسترجاع. لو باعو المجنون هذاك نتاع الزلزولي…	negative
و انت وعلاه راك تابع في تغريذاته يا نذل يا ذبابة؟؟ نعرف واحد مل من حاجة يوقف متابعت…	negative
ههههههههه مزية سڤمت التويت ، مفهت والو في اللّول 😂	positive
وقتاش تجي نتا 🙄	neutral
_مشي اي بنادم دايرلو abonnèمعناها نهدر معاه \n_مشي اي غنية نديرها معناها راني نعشق ولا مانيش مليح\n_مشي اي ستوري ندير…	neutral
وعلاه هربت قبل ماتطفى النارأحناكناثم في القالة ماخرجناش حتى طفاوها وخرجنا وقت المغرب والحمد لله ولاحو…	positive
استغفر الله ..جهلو نيشان	negative
غاضني الزاوش ولا ما يصفرش هاذاك واش كان خاصني في حياتي التعيسة هاذي	negative
علابالي كاين وكابن أنت من أعز الناس	positive
وعلاش ماتغديتش خويا	positive
وعلاش تفضحي فينا	negative
🤣🤣🤣🤣🤣والله ديري مزية	positive
لاه انت ماعجبكش زعما	positive
علابالك كاسانو كي نشرت هذ التغريدة انت اول واحد جاء في بالي \nعلابالي راح تقول هكدا😂😂😂\nتوحشناك علاش ر…	positive
و السبع زهرتو واعرة ...(الجزائر) تصبحون على خير فرجة ممتعة	positive
ماعلاباليش علاه نشوفهم صح لعنة، المنتصفات والتفاصيل، كشغل افضل واسوء حاجة تصرالك	negative
راهم احرار بصح والله يا خويا كجزاءري غاضني الحال ، اك تعرف العقلية.	negative
مع الكونغو التعب و الخلعة تاع البدايات (دوليا لعبو فقط مع اليونان قبل ألعاب المتوسط).…	negative
في معاك كان قوي جياحة و زايدة على حدها تاني \nالله يصلح الحال	negative
اللهم آمين\n\nاعلم ذلك\nسقسي المجرب لا تسقسي الطبيب\n\nسيأتي يوم وتتقبل بإذن الله \nخليك بين فينة واخرى ذكريها وبلطف	positive
هذيك هي الكلمة ""يلعبوها"" مي كي تجي لصح ماكاش فرق بين تخمامهم و بين العقلية السائدة عند العامة	negative
الشعب الجزائري والشعب المغربي خوة خوة إلى يوم الدين إن شاء. \nهمكم الوحيد التفرقة والفت	positive
الحمد لله العلاقات الاجتماعية عندنا في أقصى درجاتها ،😂في بلادنا الجار علابالو بيك وقتاش تدخل للدار ووقتاش تخرج، وقت…	positive
واقيلا لي كان يقول نحرق الجزائر علا جالك ماكانش يكذب	negative
واقيل اسمو عفسة هكا الادريسي لاعبها تاع دين	negative
جرحلها المشاعر بالعقل على الاخت حساسة بزاف	negative
نيشان خويا محمد	positive
لحد الآن مازلت ما فهمتش واش تحوس فرنسا منا، لانو في عز زيارة ماكرون للجزائر والي زعما زيارة لاعادة العلاقات، كل ا…	neutral
غاضني المرحوم	negative
ربي يعينك نا علابالي بلي كون نفوت قلبي يتحرق	negative
وعلاه يا فدوى وعلاه	neutral
وي علابالي الله غالب مافهمناش	negative
راهم يبهدلو نيشان بن عمي مشي لهذه الدرجة	negative
• من كثرة ما وليناش نقولو الكلام الطيب ولي يفرح للوالدين تاعنا ...كون تقول للوالدة تاعك : أمي انت الأفضل والأجمل وو…	negative
علابالي بيهم يحبو الحسابات تاع القفطان والزفيطي والكسكس لي يصورولهم ان الجزائر افضل بلد في العالم	negative
وقتاش حيحطوه	neutral
ڨلبي عصرتو خويا إسحق...غاضني مسكين\nمساء الخير.	negative
الحشمة ولات جياحة كبيرة في هذي الدنيا ...	negative
ههههههههه لاحولة هههه نيشان\nكيفاه كلشي فدار راجلي غير التسياق ولغسيل عندك	negative
الواجب يعشر على الشعب أمبعد كشما بقى يمدوا للجيران	negative
وهران وهران رحتي خسارة	negative
هذو نعرفهم😏\nكاش حاجه اخرى	negative
أنا ما فهمتش وعلاه يستقبلوهم......يستهلو حشاكم بزقة في الوجه المرخس	negative
غيرت من 5 رواتل زيت😏🤣🤣🤣 علابالي جامي لحقاتو هدية كيما هذي 😏😏	neutral
صح علابالي هوما اصحاب و اصدقاء من زمان و هوما راس الشر في المنطقة العربية و هوما الي د…	negative
والديها وخوها وعلاه يحرموها مسكينة 😁	positive
😂😂😂 السبان معاهم أما وقتاش عرفو يتناقشو	negative
بلا مزية تستاهلي سارة	positive
واقيلا خاص شي ثريد خفيف ضريف على الدبلوماسية 101 🤣🤣	negative
هههههههههههههههه قتلك قبل السفيه ينطق بما فيه صوالح لي فيكم…	negative
خطرة على خطرة روح سقسي على روحك فالبلدية	neutral
اعطينا اخر اخبار مواقف الاتحاد الاوربي واسبانيا علابالي انت فووور.	positive
ياو اخطونا	negative
البريكي جيب عليه عامين ضرك	negative
وعلاه خليجي حنا الجزائريين معمرنالكمش عينيكم🙄🙄	negative
زعما باقي شك	neutral
في زوج مهم تبهديلة وخلاص \n🤣🤣🤣👊	negative
و الله ما علابالي بجدهم لكان يكزيستيو و لا لا	negative
شرعية يا خو النيف برك🤣🤣🤣	positive
تعمل مزية وزيدني معاك فالتغريدة باه نجاوبهم بيها	positive
ماعلاباليش ، اصلا مبلوكبني	negative
فعلا قبل مدة كان تويتر نقي تدخل هنا ترتاح دوك تويتر اصبح مقل الفايسبوك معمر تبهليل الواحد هرب من الفيسبوك ب…	negative
واقيلا غنات عليهم😂😂	negative
ما غاضني مني ترا غير قلبي..	negative
يضحكني ليقولك توحشنا لبلاد يا خو 😭😂	negative
ماشاء الله تبارك الرحمن\nخيار الناس	positive
Amir dz\nقضية سر.قة منزل رئيس مجلس قضاء قسنطينة \nنزيدك شوية يا رئيس مجلس قضاء قسنطينة ؟ كنت عطيتك شوية من راس الخيط…	negative
انشاء الله وعلاه لا ههه	positive
RT علابالي أنت إنسان محترم وخاطيك الإعتداء ..... لكن هناك نوعية بهدا الزمان #يلزمون_عليك_التعدي_عليهم_وعلى_الطا…	negative
هههههههههه غاضني	negative
وانت والسيد اللي أعدت تغريدته غايضكم الحال كي الناس راهي فرحانة وعلاش؟؟!!🤔 ربنا هي ثاني بسبب الفر…	negative
علابالي بيك مشتاقة . نخليك كيما راكي خير	negative
حنا عندنا السي برك احة ماكاش و الدليل كي الواحد يروح للبحر يلقى غير سي فلان و سي فلان هههههه…	negative
أنا علابالي مش رح ندوها	negative
هههههه حتى هذي بنت بلادك ههههه بصح علابالي تحبها كيما انت سامبل و تشتي الخير للناس المهم نقولك تحب صورتك…	positive
علابالي بلي جاتك طايحة 🇸🇦🇰🇼💸\U0001faf0	negative
ههههههه وش دخل قرايتي في موضوع الأول من التغريدة جبت ليسانس ولا مازوت المهم…	negative
ماكاش كيفاه نراطيه ماتش مرة في 6 أشهر.... بالاك يخلاص بتبهديلة تاني 🤣🤣	negative
خطبها وعلاه راهي تبكي 🤔\nالف مبروك والعقوبة لي مزالت متزوجتش	negative
ماعلاباليش وين رانا رايحين فلالجيري بهاد العقلية تع les jeune قع ولاو des drou*gé و مايخدموش و مايقراوش عالعام شايد…	negative
نو نو ختيتو كرامتي فوق كل الحب \nشكون ما يبغني ما نبغية \nما نكسرو قاع pont.. 💪	positive
راك تخدم على شرك ازونا بلا تبهليل	negative
وعلاه عشانك في جيبه؟	neutral
اخدم خو كتر من تتنفس اكسجين يخلاص و دراهمك مايخلصوش زكارة في لي حقروك 🖕	negative
واقيل راكم بزاف ، سماح امسحوها فيا وصاي 🙏🙏	negative
يديروها عادي علابالي 🤣🤣🤣	neutral
وي علابالى رحت للمغرب فوق هذا مرت خويا قديمة مغربية ولاد خويا مغاربة 😍	positive
اك ناايس😂، ماعلاباليش واش نرد🗿\nليلة سعيدة	positive
لا حول ولا قوة إلا بالله وعلاه سبت الجزائريين؟؟؟؟	negative
يعطيك الصحة. عندهم كلام ماكاش اللي يقدر يفهمو	negative
اشحال غاضتني يا ربي \nربي يرحمها ويصبر ذويها \nانا لله وانا اليه راجعون	negative
واقيلا ؟؟؟ كنتو صغار و عل	neutral
يمدولهم باطل نت واش دخلك \nواقيلا تسال فيه	negative
الأكل والنوم واللامبالات وغياب التخمام وكاين يماهم ثاني تسمن لبنادم \nاما زعما باش يكون الشي للي تح…	negative
اخي مصطلح قهوي لا يريد به سكان الارياف هو مصطلح للناس اللي قليلة الأدب (العراية ) و رانا نتلاقاو بيهم كل…	negative
واييه ولكن شوف وقتاش جاو ملي هاد الكسول…	negative
لي يحبك صح يعرف وقتاش l""anniversaire تاعك 😌✅	positive
الحمد لله يا ربي كيعاد لاباس\nبلا مزية ربي يفرحك	positive
نضيفوها اليوم معليش تستاهل امبعد تحكي لنا عن الادب الروسي	positive
مسؤول قهوي	negative
مي من نهار سمعنا بالمبادرة مازادو خبرونا عليها والو \nشكون يحضر ، وقتاش يعقد لم الشمل	neutral
قاعدة علا قلبك واقيلا	negative
وعلاه مغطية وجها بعلم الجزائر ؟ حشمت بيه ؟\nالمهم راهي عارفة من اين تؤكل الكتف، خليها دير les affaires	negative
عندما ماتت سيمون وبكى عليها هزيم الرعد شبعت بكا غاضتني وغاضني هزيم الرعد	negative
ناس سكيكدة خيار الناس	positive
قاع ماشي نيشان 😠	negative
ني غالطة واقيلا ؟	negative
20مليون تمدهالو هي خالتو ماشي نتا 😭 \nأنا نعرف الخوال والعمام لي يمدو دراهم بزاف وولاده	negative
قلت مزية أنا؟؟؟؟	neutral
عادي ارقصي.. ضرك عروسة من اللي تبدى تصديرا و هي تشطح علابلها واش جايها 😂😂	negative
فيني حاجة ان اذا عندي فلوس كاش ما اصرفها وتضل عندي فترة طويلة \U0001f9721	neutral
غارت عليه واقيلا 😏	negative
مزية والا طارو فيه ههههههههههههههـ	positive
وقتاش يخرج او ين يديروه باين شباب رايح style حريم السلطان	neutral
كي تشوف هذاك الولد هاز الفيميجان تفهم بزاف صوالح 🤦\u200d♂️🤦\u200d♂️..\nكنا مريحين من جياحة تعهم، كانوا يبثو سم زعاف في المجتم…	negative
كسكس بالعصبان مع مرق أبيض ولاية جيجل ❤️😘	positive
راني شايفة بلي مستقبلا راح يكون عدد المصابين بسرطان الجلد جد مرتفع مع البوتكس و الفيلر و ابلازما و ماعلاباليش وشنو…	negative
عندو مدة يستنى في الجلسة متاعو وقتاش يعينوها	neutral
السلام عليكم أصدقائي و أحبتي في شحال مشفتكمش و مهدرتش معاكم 🥰❤️ توحشتكم بزاف 🥰\nلبنات لي نعرفهم رسلولي الفايس تاعكم…	positive
مام كي غاضتني ضحكت 😔🙋\u200d♀️💔	negative
😲😲 ان شاء الله وعلاه لا 🤣🤣 تفكريني بوزارة 😁😁	positive
في زوج نفس المقام حنان بزاف وعاقلين الحمد لله	positive
علاش زعما ؟	neutral
الكل عارف وعلاه الشباب يحرڨ ماكلاه دزيدو عليها لا فقر لايديك لا يجيبك (الساعة بخمسة جنيه والحسابة بتحسب )والفاهم يفهم	negative
😌❤قطوطة حنان مدام تبعيهم يعني حنينة بزاف	positive
هو نيشان 😂\nعلى سلامتك خدوج هادي غيبة	positive
وعلاه كيفاه عرفتي بلي هو	neutral
🙄🙄🙄🙄🙄زعما واش الفرق	neutral
علابالي الفرنسية خلاص وقتها او الانجليزية هي لغة العلم انا واحد من الناس الد…	neutral
عفوا ماشي الإنفتاح واقيلا بغيتي تقولي الإنحلال حيث كاين فرق بين الإنفتاح و الإنحلال الأخلاقي.	negative
علابالي تغيض الحيوانات بصح انا قصدت بلي الارواح البشرية هي الاهم هدا ما كان	negative
وجعاتك الحقيقة واقيل ؟	negative
😂😂نيشان وكي جات جات	positive
تفضلي سقسي فرنديقتي و علاش مترددة 😁	positive
سقسي يوسف😂😂😂😂😂😂	neutral
وعلاش ماكانش توظيف يا عباد الله الشباب ضاع رانا بشهاداتنا و ماكانش خدمة علاه يا مسلمين علاه ا عباد الله	negative
تبهديلة ما بعدها تبهديلة	negative
سطيف العالي👍من أصلكم الطيب.. شكراً 🌿🕊️	positive
حيها حي ليا 3ايام نتحرك بالسيف زعما كورونا 🤕😷	negative
يبارك فيك يا خو	positive
وعلاش رحلتوا منه🥺🥺🥺	neutral
يا مابقاش اللعب مع لهوايش...اخدمو خدمتكم نيشان طلعوه للحبس حتى يبطل الإدمان طلقوه...المحكمة ماتنفعش…	negative
هو اوريدي مدام كان متفق مع يوفنتوس على المرتب ورجع في كلامه وعلاه يبقي متفق مع نادي تاني\n\nبس طلع بيفهم عموما انه مراحش يوفنتوس	neutral
شرفي من بجاية: شعار ""ماكاش الفوط"" موقف سلمي وديمقراطي ونحن كلنا أمازيغ\nالتفاصيل:	positive
الإشتراك غالي بزاف بزاف بزاف 😭	negative
70 درهم و مكايناش قليلة بزاف	negative
زعما قارية 🤥	negative
نيشان خويا😅😅😅 راه غالبني الحمان	negative
راك مثبت؟ماكش ضارب كاش حاجة هههههه لا حول ولا قوة الا بالله	negative
بلا مزية معاك للابد	positive
زعما تقدري ديريها نتي	neutral
نتا علابالك وانا علابالي مش حيعيط لبن عيادة راو بلا نادي الا اذا كشما اصابة لواحد فيهم وتحتمت	negative
يعمري غاضتني 😥🤭🙃\nبصح لبنات بلا استثناء وااااو برافو عليهم كي يقدرو يستحملو رجال لي عنده هاكا \nصراحا تمنيته ل mommy👑🤩	negative
سددت فاتورة اول مرة عادي أمبعد لقيت الدراهم ناقصين	negative
جامي نضحك على كاش حاجة بصح نشوف واحد يضحك يضحكي منعرف علاش 😭😂	positive
علابالي شدة و تزول ، بصح ثقيلة ولله	negative
ا ولد خالتي مازال ما فطرتي واقيلا ، راه تغريدتك الاولى غي نظرية ، و الحساب و البعث نظريات .. و الدين نظرية…	negative
وي نعمة التربية وما شاء الله .\nعلابالي راكي عليا ههههه🤣🤣🤣❤️	positive
وعلاه ياخويا واش درتلك 😂😂💔	positive
انت موسوس على روحك مقتلك والو قتلك اصلك ربما تحريت عنه و وجدت انك عربي كون عيني كاش حاجة راني قلتهالك متتوسوسش اخي	negative
زعما مايديروا والو كي نقيسها عليهم \nولا الهربة تسلك 😜😜	negative
نتي تابعتيني ولا انا تابعتك؟؟\nانا لا اعرفك\nنتي جيتي تابعتيني سقسي روحك مالا	negative
ياخويا ذرة كرامة ما عندوش .ماكاش gاع النيف	negative
ههههههههه علابالي ايه	neutral
مرحبا والف مرحبا ببنت بلادي وشرف لي وشكرا على كلامك الطيب والله اثر في. ربي يحفظك ويرعاك والله يكبر بيك، وهدا واجبي…	positive
علابالي ولكن لا تليق في اعتقادي !!!!	negative
القمر يبان وحدو 😍😍😍\nحوست عليك ما جبرتكش تا جيتي وحدك \nواقيلا سينيال	positive
لع نكم الله يا خو نه يا اتبا ع الشي طان\n\nعندكم فكر صهيو ني	negative
راك بعقلك زعما 🤪	negative
RT تكون لداخل، خليها عي فسطح. ما عرفتش علاش شاركت هد الفكرة، واقيلا حيت أنا مهووس بdynamics ديال العلاقات الإجتماعية و تأثير…	negative
هههههه مزية قلتلي باش نجي ديراكت 😂	positive
و الله حسبتك طفل بديت أسمحيلي مادام خاطرش جياحة نرد على طفلة	negative
الله يحفظك سفيان على بالي وليدها و اذا جيت لتيارت مرحبا بيك	positive
وعلاه زعماااا ٢وت روعة 🙂🙂🙂 حنين بالبزاااف	positive
بكل بساطة كلمة قهوي التي يستخدمها بعض الناس على سبيل المزاح والضحك على فئة من الناس في الواقع لها أبعاد كثيرة عندما…	neutral
غبني غاضني 💔	negative
علاه نيجيريا حومة واقيل	negative
مزية مهمش محسوبين معانا هههههه	positive
علابالي ربي يعيشهملك راح نقولك اشغل روحك بيهم ألعب معاهم بالاك تتحسن نفسيتك لولاد نعمة من عند ربي…	positive
اليوم في تمنراست\n05 لتر بنزين بي 1000دج.\nعين أمقل 5لتر ب 150الف\nميزيرية و تحيا كاش حاجة	negative
نسيت روحك واقيل	negative
شبيه ماتلو واقيل😂	negative
غاضني مسكين و الله راهو تحريشة في الجزائر ههههه هه هذا تلاوه عطاولو 20 درهم و قالولو قول هك محابسي مسكي…	negative
وعلاه ماديرش ابوني و تفرحني	positive
أعلاه تقول أن الصفحة بعيدة عن الإعلام وأنك تنشر هنا بصفتك مواطن بسيط.وضرك تجي تقلي هذه في الصحافة تسم…	negative
علابالي ولعب فالمانيا مي مع المنتخب ماكانش يعجبني	negative
وعلاش طيح غول	negative
Aaaaaa sahaaaa\nمااا ندري😂\nسقسي واحد مجرب😂	neutral
علابالي رانا نضحكو برك 😄	positive
والوو تبهديلة تاع الصح	negative
RT هاو جاي #ماكرون \nايه علابالي\nياك عندكم 5000 حايك\nايه كاين و سربيناهم \nأيا مليح هكا تحمرولي وجهي☺️☺️ قدام ماكرون\nنتوما الر…	positive
زعما تريبوندي؟ 😩	negative
مامتش واقيلا	negative
هي انا ضامن بلي راح ينصاب قبل تربص عطال رخيىس \nبصح\nوعلاه حابة يدخل عمورة ؟\nراني متأكد بلي ضمن الاساسية \U0001f979	negative
_منسمعش راي و جياحة هذي \n_راكي ظالمتني مراكيش فاهمتني \n_ سيفريي تااع ميليووو في عشقك سيريووو	negative
ألفاظ تدل علي أنك قهوي في تفكيرك لو كنت ولد لبلاد عيب تكتب هاذ لكلام لبنت بلادك 👌	negative
أخطونا معباد الحيوانات رافدين غل كبير على المسلمين	negative
#عنتريات_فالخاوي\nالمهم فاتت عليا تغريدة و راحتلي باش نديرلها رتويت ماعلاباليش صاحبها من وين لاكن يهدر على استقبال ا…	neutral
زعما شحال تحب الدراما	negative
كي يشوفو ماتريكيل ليبي يرحبو بيه و يفرحو بيه … بصح كي يشوفو ماتريكول من مدن داخلية يتشارو عليه بلي قهوي	negative
خلاص الخاوة بزاف، من فضلكم	negative
والله ما نعرف يا خويا ساعات نوض مقلقة مافهمت علاه قبالا مقلقة صح و نحب ندابز هههههه طفلة صباح تنارف…	negative
ثمن شراء حبة قدش؟ \nعلابالي يتباعو بالجملة حبيت نعرف بقداش	neutral
ماكاش كامل لي يقيمك ويقولك كيراك شوية😡😡😡😡😡😡	negative
واحد الاتيكيت فناس شركة بريطانية واعرة دايرين سياسة الى بغى يعيط ليك واحد خدام فيها واخا يكون صديق يسيفط…	positive
اخطونا:\nوالقيت غير الصورة هذي تحطها لي تضهر فيه انك مسيطر ..الجزائريين لي يسكنو في الجزائر ولي متج…	negative
راكى تطعنى فى اخلاق الجزائرين يمكن ما تعرفى لى الأصول نحن ك جزائرين مكرمين وهذا يشهد عليها كل من…	negative
مسكينة غاضتني	negative
وقتاش يكون التغيير ان شاء الله في صالح الشعب	positive
أصحاب العيون البنية راكم هنا ؟؟\n😂😂😂بكثرة علابالي	neutral
انا في حالتي ما خلاونيش ندخل حتى للبلدية، قالي عطيني البطاقة الوطنية و شاف في النظام و قالي خ…	negative
ماشي ساهلة يكون معانا أعداء مقنعة تدعي الوطنية و دس السم في العسل، تونس دولة ذات سيادة و عندها تاريخ عري…	negative
وعلاش بالاتصال الفضائي؟ 🤔	neutral
واقيلا غي أنا وليت نحط ليفوطو لقدم خاطر موليتش نتصور	neutral
BRING THE STREAM ON\nهذي سمعتلها بزاف اليوما شكيت ما نحلمها😂\n#BTSMOTS\n#TeamMOTSDo	neutral
غاضني ثانية و منبعد تفكرت بلي كسر قلب اونتشان 5 مرات 😤	negative
ماعلاباليش علاش قريته برويطة 😂😂	neutral
حتى في حالة صحة الخبر انتم غير معنيون 😂😂😂 ماكاش خو برك	negative
الملاحة جياحة والأمان بدعة.\nوين غبتي يا لالا وحضرتي يا إيه\nكون ما حضرت كلمة لالا ما نعودش أنا سفيه.	negative
غاضتني تونس يحكمها السفهاء .	negative
مكنتش علابالي بلي مرفوعة حتى ولهتني نتا	neutral
وقتاش الجزائر فرضت على الليبيين فيزا ؟\nطول عمرهم مواطنو الدول المغاربية يدخلو يخرجو بدون فيزا مثلما يشا…	neutral
امين، بلا مزية ختي	positive
وعلاه كف.يا معلم قول سيكوبراس 😂	neutral
انا نحب الجنوب فالربيع منعرف الناس وقتاش تحبو بصح انا الرلايات الداخلية و الجنوب عشقي فالربيع نحس راحة نفسية	positive
انا وين علابالي 😂	neutral
واقيلا العكس	neutral
علاه الحرائق فقط في اوت بشكل مرعب وعلاه نار اليوم لهبت فجأة وبسرعة وبطريقة مخيفة وزاد كمل عليها الريح وبلا ما يفيق…	negative
شحال منهم اوولوووفات	neutral
😍😍😍 وقتاش يتحقق هذا الحلم 🙏	positive
وقتاش قالو لكلام هذا؟؟؟؟ لووووول	negative
تسير فيه كارثي انا وقعت معهم في موسم 2015/2016 و مكانوش خدمين لي اورقي نيشان و كاين ناد…	negative
وعلاه اسيدي \nبن سبعيني افضل ظهير ايسر في افريقيا \U0001fae4	positive
خخخخ اتفلسف و زيد اتفلسف كيما وصاوك يالعياشي ، ماع…	negative
البارح برك.كانت ندية .. هي زيارة عمل ومصلحة ولكان تعطيه لي فوقك وتحتك لن يعتبرك اخوه .. \nاخطونا مالشيتة لي ماتدي ما تجيب ..	negative
وعلاش الزوج يلبس معاها الذهب 😂كل ما ذكرته سابقا استعماله مشترك بينهم إلا الذهب ذهبها 😂	negative
اخطونا يا ربي ، بعدونا	negative
واقيل نشرو puce نديرو بيها قعدة تقول راديو نبداو بلعقل 🤣🤣🤣	neutral
كان ناض ليه صداع مع شي رئيس (بلقشور واقيلا)	negative
وعلاه مزال كاين عيباد يهتمو بل مضهر تاعهم كثر من تصروفاتهم	negative
زكارة في بوش الأرعن	negative
آي مسكين غاضني راح يمسحو فيه الموس لأنه فقط مسبوق قضائيا ولقاو عنده 3 بريكي \nالدولة الفاشلة	negative
وعلاه الكلمات التي لا اساس لها.المتزامنة و داءما تلسقوها لانها بفعل فاعل .قل ربي يلطف	neutral
بسبب العاب البحر الأبيض المتوسط ههههه	negative
Fact : \nكي تولي تكره بنادم وما تحملوش ، تولي تشوفو بزاف وفي كل بلاصة .	negative
تبهليل el garghotti يستمر مع المتبردعين.	negative
هههههههههه ياي كون حتى زوج توأم نورمال المهم نشوفهم\nوالله مرحبا بيك راك على عيني وراسي و قليل	positive
🤨🤨 زعما😦😯👏	negative
دير دراهم يا خو منبعد ساهل	neutral
ههههه علابالي كنتو تتقلشو بيه في البيت ههههه 🤣	neutral
الماتش التاني اشبيلية واقيلا	neutral
شتي واقيل يامات كأس العرب قاللهم احكو عربية	neutral
علابالي تحوسي على هدي موديل تاع صبيغة شعر ههههه 🤣🤣	neutral
😂😂😂😂😂\n\nيعومو بزاف في جيجل و القل بالاك الماء تاع ذيك الجهة هو السبة .	positive
فالذزاير.... تعيش بزاف عليك	negative
شعارنا الزكارة...عايشين زكارة من اجل الزكارة😈	negative
وعلاه لابسين قش الشتاء الدنيا سخونة وهوما مشتين على الأقل يعرفو يكدبو	negative
🤣🤣🤣🤣🤣🤣🤣🤣 ياو احشم يا اكبر قهوي	negative
ان شاء الله خويا مرحبا بيك	positive
أواه مزية رحنا في الأفواج الاولى هههههه	positive
وعلاه تفتحوا الجرح 😢😢	negative
هههه واقيلا مكانش قراية هدا العام	negative
😅😅😅😅وريلنا كاش حاجة شابة فوطو من الطبيعة ولا منطقة سياحية كل خطرة توريلنا غير يدك ههه شفناها خلاص مزحة فقط…	positive
علاش تبون ميشربش زعما هههه	negative
😂😂😂😂😂😂😭😭😭😭😭😭كان علابالي😂😂😂😂	neutral
مالا سقسي مول المحل 😏	neutral
من وقتاش عندو الاخبار هادا باغي يثير الجدل و يجمع تعليقات و اعجابات	negative
علابالي واعي ذالك نتألم من الداخل ولا نحرك ساكن 🤔🤔	neutral
المواطن الليبي اللي عايش فالحرب يتمخمخ فالجزائر\nو الجزائري اللي عايش فالحلم يجري مور شكارة لحليب😉\nالمهم الميزيرية و…	negative
ما تنفعلش bb علابالي تجيك اول فرصة تهرب لاوروبا	negative
الله غالب تخمام لعرب كي شكبي \n\nما فهمتش وعلاه يتعاداو و فالخر كلهم مسلمين…	negative
شت هداك بنادم لي خسرت قاع عيباد على جالوا و قيمتوا و حبيتوا من قلبك و خسرت وقتك و روحك غي باش ترضيه هداك غادي يكون…	negative
وعلاه يندمو مع كاسيميرو جابو بيه 5 دوري الأبطال ويجيب بدراهم برناردو سيلفا المهم الدراهم داخلة خارجة ما…	positive
RT الخميس و البحر فور بزاف🤗😍	positive
وكتا سقسى عليا خويا عبد القادر\nغير كيما كنا حكينا مع بعض	positive
تعرفش وقتاش تقال لكلام هذا؟ شكرا	neutral
كي نكون نصلي أُمبعد نعفس على الخيمار(الحجاب):	neutral
RT ههههه ماكاش منها القافلة تسير والكلاب تنبح لازم تنزل وتعطيهم طريحة هههه	negative
يومين بزاف\nنورمالون مع الوصلة يدير خاف در	negative
علابالي بروحي 😎😎😎	positive
مزية مبولحي يخرج عليه كلش	positive
هذا رايك و انت حر فيه بطبيعة ..\nو مانيش مستغرباااا من رايك ياخي انت من وقتاش تعجبك حاجة ...\nاصلا انت د…	negative
من بين أحسن اللاعبين لي شفت فالواحد على واحد هو محرز، يشرب معاك قهيوة و يقدر يخبط ليك راسك مع الأرض بلعبة دارها آلا…	positive
وعلاه تعطيلو في التارخ؟. دوك يحضر روحو😁	neutral
واقيلا كاين غير انا لي كي واحد يحط story او انا ما نشوفهاش يحكمني الوسواس	negative
📌👈 هذا هو محافظ مهرجان تيمڨاد الي مشات فيه الاضاءة و الصوت 🤣 وشكرا 🤣🤣🤣\n👈 وقتاش كبر 🤔 وقتاش قرا وتخرّج 🤔🤔\n......والت…	neutral
RT حشوما عليك تقول هادشي، راك شاب قاري و واعي زعما اسيدي نسقسي ليك فالبلدية ونرد عليك	negative
شريكه في الجريمة فاق ولو بصفة متأخرة وأنت وقتاش يا دغفة يا مدك 😀	negative
بصح بزاف قاع كيما استغباء فهذا الشعب رجعونا اغبياء وذلونا نيشان	negative
قهوي احسن من الروز	negative
ساعة وانا نقلب في الصفحات..\nأيا..هذا وين فهمت كلمة: ""قهوي.. 🤔 إضافة كبيرة ونوعية في علم terminologie يا جدك واحنا ل…	positive
الا زعما على ضمانتك	neutral
حتى هو يقلك سقسي لمجرب ومتسقسيش الطبيب 😁	neutral
آش داني وعلاش مشيت... هههههههه	neutral
رواحي شوفي بلي جبتها نيشان 😭😭	negative
واقيلا رايحين ديرو مزية ... ياك كل واحد يتحاسب وحدو في قبرو	negative
فان دايخ زكاره 🤣	negative
تغيرت العقليات واقيلا	neutral
بلا مزية ♥️	positive
بلا مزية زهرة وااجب	positive
كلامك فيه تناقض .. وعلاش تدعي ؟	negative
🤣🤣🤣\nعقلهم غامل	negative
ناجحة من اي معيار اخطونا	negative
علابالي جاك نيف على ماكرون بصح يظهرلي مزال هنا تقدر تمشي تشوفه	negative
ياك انت فاهم بزاف	negative
الله يبارك\nفيمن راه يأثر؟\nماكاش حد اسمع بيه غير انتوما	negative
وعلاه جاهلة كيفك مملوكة	negative
شحال جبتي معدل	neutral
أطالب الحكومة بجعل 50% من واردات الدولة كلها لتمويل البوليزاريو.\nزكارة ونيف.	negative
RT ماكاش لي يقلق كيما صحاب الانرويد كي يبدلو للايفون(iphone)	negative
على حسب موقعك يبدو أنك صاحب نظرة ثاقبة .يخي تبهليل .	negative
وعلاه الصورة تعيف	negative
مكان هايل هاذا رحت ليه ماشاء الله جيجل جميلة فعلا اكيد نقبل انا هههه	positive
🤣🤣🤣🤣🤣 لوين غادي تولي 😅😅زعما 😁😁	neutral
لاصق مثل البقة ….. اخطونا اتركونا نتقدم في سلام	negative
أنا بصراحة ما نتبعهمش بزاف لكن اكثر واحد فالجزائر يعجبني هو الشيخ فركوس، عالم كبير ربي	positive
هذا التافه لا يدري اصلا معنى كلمة قهوي، من هذا المنبر و لي عندو عرف مع هذا التافه ماذا بينا يفهمه ا…	negative
RT يا حبيبي ماكاش لي ما يحبش بلادو الجزائر على العين…	positive
ما فهمتش علاه راني نرقد بكري وكلش بصح نصبح عيانة و ڨوايمي ضاريني ما هذا يا جسمي ايه الحركات دي ؟!	negative
بلا مزيه أختي سارة إن شاء الله موفقه في باقي المشوار	positive
هاو جاي #ماكرون \nايه علابالي\nياك عندكم 5000 حايك\nايه كاين و سربيناهم \nأيا مليح هكا تحمرولي وجهي☺️☺️ قدام ماكرون\nنتو…	positive
علاش وقتاش دخلت للحبس من أصله 😑\nصرااحة اسحاق بقی حل واحد وهو تغيير الشّعب .!!	negative
وقتاش تبدى	neutral
غاضني غير اوباميونغ كيفاه تحاوز	negative
وعلاه ما غلقتوش حتى انتوم لمدة بسيطة ؟ 😂 لأنكم جبناء و انذال	negative
😂😂😂😂 حكمتي الصيد من ذيلو واقيل 😂😂😂😂	neutral
علابالي لكن نحي تع ليميساج بش معاتش بدخلو للخاص غير اذا انت تابعهم لازم هكذا	neutral
خلي البير بغطاه اني تكلحت لقيت اقتباس أقتبست بلاما علابالي واش رح يصرا 🤣🤣🤣	neutral
أكيد خويا سقسي المجرب البنات نعمة و الله 😍😍😍 ربي يحفظ لنا أمهاتنا و أخواتنا و ازواجنا و بناتنا يا رب العالمين	positive
ربحت حرية تعبير ؟ وقتاش 😒	negative
بزاف بزاف 😂😂😂	neutral
وعلاه انتي ملاكة الجمال	negative
ماشاء الله تبارك الله استاذنا الفاضل والشيخ الكبير لي معاك انا قهوي وافتخر	positive
لاحول ولا قوة الا بالله تقلقتي صح ما في بالي والو بصحتك بصحتك أو علابالي وديما نشوف تغريداتك 😂😂🤔🤔	neutral
وقتاش شفت واحد يشيان في الحبس يا بوقوقو ، ماكلة و رقاد	negative
صح ديما نضاربو و ديما نجرحو بعضانا و صح خطرات نزعف منك و منبعد نتفكر الوقت لي جوزناه مع بعض نتراضا غير وحدي مي جامي…	positive
المورال تاعك إيذا مطلعتوش بيدك ماكاش لي يطلعهولك	neutral
علابالي راك جيعان و عطشان	negative
كان يعمل مزية يجيب معه استقالته	negative
رحلة ممتعة اوووف وقتاش نعاودوها	positive
مزية الواحد ما يعرفش فرونسي \n	positive
كي تتعلم تكتب لعنة امبعد ساهل نجاوبوك 🤣	negative
سوق اهراس جاتهم ثقيلة واقيلا 😡	negative
والو مارشاريار ماكاش زدمتي تكملي هههه	negative
روح راك نيشان	positive
ماعلاباليش، بصح واقيلا لا لا	neutral
مزية عرفتوه حمار	negative
ما لقيتهش في قناة التيلي زعما نزلت في موقع !! \U0001f972	neutral
وعلاش مايروحوش يديروها وين كاين زطايلية و لي فوايو ؟	negative
بصح منجمتش لانو دخل العنف الجسدي من قبل الراجل و الاهل منجمتش هي عاقلة بزاف و مهيش تع مشاكل عيات حاول…	negative
وقتاش نشوفوووووو هذو الملاعب ولا غير تتحدثون عنهم	negative
ربنا معاكم يا خو❤️	positive
يا سيدي جياحة كبيرة في المداخلة .😤	negative
منحاولش باينة، لوكان عندك رد تو صح كاين خطأ في كلامي لوكان ىتك بينتو، مي متقدرش، علابيها تبلوكي او يبلوكي…	negative
نقدر مانحلفش بصح كاين ادلة بزاف 🤣	neutral
حبيبي نتا علابالك او انا علابالي الوقت تبدل دوكا المرأة متسخقش راجل انا راجل او نقولها…	negative
علابالي بيك مكراشة بن عمي ،😐😐😐😐😐	negative
غاضاتك علابالي حرقتلك قلبك 😂😂😂😂	negative
وقتاش يا خولة اخر معلومة عندنا تأجلت القضية ... ولم يعلن عن اطلاق سراحه	neutral
لكن انت علابالك وانا علابالي بأنهم يعلمون ان هذا هو الحل ويعرفون كل الحلول\nلكن اقسم بالله العلي العظيم…	positive
هههه زيد في الفايسبوك يخلوك تهدر بزاف اكتب جرنال حتى تتعب، في تويتر يقلك احكي كلم	neutral
علابالي في كلش،انا برك ساكت و داير روحي معلاباليش 😉	neutral
مشي تليفون حجة التقافة الشعب معندوش وعلاه اجنبين متقفين	negative
واحد المتاحف في تطان ما عرفت وقتاش كيحلوهم مشيت ليهم لقيتهم سادين	negative
هاذي لي غاضتني زويا عندك 40 الف متابع مايفكو مايصكو بدون تعميم سمحيلي علا كلام \nوالمسابقة وين كانوو ؟ \nانا…	negative
و ماكاش التريسيتي 💥	negative
وكل مرة طاقي التيكتوك تاعهم ثاني بغاتهم يشوفوهم بصح علابالي مادام سحر الجير…	negative
و يزيد يقولو اذا ما امنتنيش سقسي اسلام (لي راح يكون زميل تاعو في الفريق)	neutral
مزية قتلي😂🤦\u200d♀️	positive
وعلاه ماتختاصروش الموضوع و تخليوه يطير من درك 😑	neutral
و الله ماعلابالي ،المهم بيتها في كاش حاجة و خلاص 😂	negative
☺️👌🏼قال لك القهوة يدين وتصلح حسب نية الإنسان خاطر القهوة شريفة.. مرحبا بيك حللت أهلا ونزلت سهلا❥ڰ	positive
وقتاش قالوها هاذي؟	neutral
معباليش وعلاه اكثر الناس لي نحبهم هم لي يقولوا مفمتش في ليكومنتار في التيك التوك 😭❤️\u200d🔥	positive
مزية ماندخلهمش	positive
زعما حنا لي يكون فينا ديفو!؟	negative
علاه كاش ما قلت حاجة عيب او من ذا القبيل	neutral
اما !ماكانش علابالي	neutral
هادي نخلة ولا نحلة ولا نهلة بهلولة من وينتا رجعت مغنية! لحد الان مسمعتش ومنسمعش اغنيتها، ڤالك دارت قالب بلي بعدت عل…	negative
تصرا 😂😂معايا بزاف	neutral
علاه اليوم يدخل الشيطان للجزائر وآلله ما علابالي	negative
ههه علابالي راك ثم	neutral
تبهديلة 😂😂😂	negative
✅- مزال عايش مع داركم ؟؟ \n✅- وعلاش راك لابس هذي لبسة تع كوافا؟\n✅-اصرف شويا على روحك ؟!\n✅-مزال مادرتش التاويل ؟ \n✅-و…	negative
من وقتاش\nنعرفها مجرد مزرعة لرعاة البقر	negative
واقيل راك سكران مثل الملييك	negative
👏 ماكاش حاجة تجي من العدم، في تاريخ الانسانية البشر يتأثروا ببعضهم البعض، \nمثل المعمار الاسلامي اللي في الح…	positive
لاباس الحمدالله\nسقسي عليك خير وين كنت سايع 😁😁😁	positive
مزية فهمت روحها \nمش مخصوصين شطيح ورديح	negative
ماعلاباليش😂😂😂	neutral
جياحه اتخيلك معي واتمنى ان تكون جنبي ارتقوا شويه ياشكوبي الحرب العالمية الثالثه على الابواب	negative
لما تخلص من عند دكتور الأسنان :\n🇺🇸: ثانك يو\n🇸🇦: شكراً جزيلاً\n🇩🇿: وقتاش نقدر ناكل ؟	neutral
من علامات قلة الأدب: \n✅- شحال تخلص ؟؟\n✅- مزال مجبتش ذراري ؟؟\n✅-واشبيك قاعد عازب ولا قاعدة عازبة؟\n✅- واش بيك شينت وا…	negative
هههه ايه علابالي بيها يا ذيب هههههه	positive
ياو علابالي بصح كلمة عيانة""لفظ سوقي"" تقدري تقوليها قدام باباك مثلا نهار العيد و لوكان جات نورمال و مالا…	negative
تقدير لطافة الشخص يعتمد على شخصية الطرف الثاني \nكاين لي مريض يشوفها جياحة\nوكاين لي محروم يشوفها حب\nوك…	negative
گلتو لينا دارو مدكرة تفاهم ... ! وقتاش الاتفاقية.. ؟ الله اعلم... ؟	neutral
اصبري واقيل تصيبها ب anglais	neutral
وقتاش باش يبداو يخرجوا يشلطوا في رواحهم؟؟	negative
والله نيشان	positive
اااه يتسما جديدة في دزاير💗💗💗 مرحبا بيك في بلادك ان شاء الله ما يخصك والو🤍	positive
RT العار والعيب أنو تلقى قنوات كيما العربية والحدث مدايرة تغطية على الحرائق والشيء لي راه صاري في الجزائر والقنوات تعنا مدايرة…	negative
يسلمك مرحبا بيك وناس تلمسان 🌹	positive
نتا فايت فابت حط متابعة🙂\nلبغيت زعما 💔\nعلابالي لفيديو ما يشوفو حتا واحد 😣❤️\u200d🔥	negative
راه رافد كاسيطة تاع حسني ؟!!!!\nاخطونا لجاه ربي	negative
الأصدقاء يفرحو وقتاش تجي الفرصة باش يخرجو مع بعض\nصحابي :	positive
كان علابالي \nوالمصيبة تلقى واحدعايش في الذل فرحان ويدافع على نظام فاشل وفاسد	negative
عمل فيك مزية حتى ماتشوفش شخبطاته مايوجع قلبك	positive
😍😍\nوهران الناس الزاهية\nخيار الناس🤗	positive
سألت زوجة زوجها. وين كنت ؟ قالها ماتخافيش انا حاج بيت ربي مانديرش لحرام \nقاتله علابالي راني خايفة من الحلال 🤣🤣🤣	positive
وليت نكره الصيف من هذه السناريوهات مافيا العقارات ادوها سلمية وعلاه منكر هدا حرڨتونا	negative
روح شوف وين تزوخ هل تعلم أن الجزائر في عشرين سنة بنت أكتر من أربعة ملايين مسكن بما فيها الارياف مربو…	positive
وعلاه راكي تسوڨي في طيارة علمينا نسوڨو	negative
#القهوي_كما_لم_تعرفه_من_قبل\nحتى نضع الجميع في الصورة معنى كلمة قهوي و أصلها:	neutral
ميشفاش العبد وقتاش ناض😒	negative
غاضني 🥺واش يوري واش يخلي 🤭😁	negative
يا انتم يا نحن ماكاش خيار ثالث	neutral
لي يدير الفتنة الله يجيبها فوق راسو ونعل الله من ايقضها العاقل من الجزائريين او المغاربة لا يسمع له…	negative
انا كنت معاهم وقتاش صورتوها؟؟?	neutral
أنا مضلموم لدرجة كون نبقى ساكت يقولو راه ساكت خاطر دار كاش حاجة: 🙂💔	negative
زعما وش تعني بأيام الصغر 🙄🙄 راكي فايتة الخمسين ول	neutral
وعلاه ناس يشنفو هكدا لالا	negative
أجمل شيء 🧡 وصغار وقتاش يجيبهم 😂😂👌	positive
فيلم ماشي مسرحية واقيلا 😂😂😂	neutral
وعلاش ذكري سيئة ؟ وعلاش حظك عطيب؟ وعلاش مخزنينها ذكري أصلا؟	negative
🤣🤣🤣😇😇😇\nغاضني مسكين ههههههههههه	negative
صدقيني و الله ما كنتش جوزت عندو.. كنت نعالج في يدي... و الله ما نداوي عنده و بدل طبيب.. ي…	negative
ههههههه علابالي تحبوا ذيب نصف الرجال تحبو يقولك ذكي و مغرور و وفي 😝	negative
كاش حاجة وخلاص ههههه	neutral
قوة ضاربه و نص و لي ما عجباتوش الجزاير يضرب راسو في ستين حيط … ممكن جدا انت من جماعه لي شعلو النار… جدودنا…	negative
اوو ماعلاباليش بصح راني مقمر على اليونايتد تربح 😂😂 قمة اليوم خصوصا تعليق بدراجي 😂	positive
😂😂😂😂 مازال متربيتش 😂😂😂من صبح ربي و انا نرخس فيك و نتا هارب القدام 😂😂😂عجبك الحال واقيل 😂😂😂	negative
تڨول يقريو فينا مزية😂💔:	negative
وعلاه ماتحكيش على الطيارة لي كراوها وهي خردة وعلاه ماكانش محاسبة	negative
🤣🤣🤣🤣واقيل مزالك مريض عينيك خرجو	negative
انتم انتاع اشطيح ورديح اخطونا	negative
هاديك عندها شخصية قوية. واش العلاقة بين ضعف وقوة المرأة مع انوثتها أو عدمها زعما إذا كانت بهلولة عند…	negative
غاضتني مرتي المستقبلية تتخيل فيا قاوري و شباب ...	negative
صاحب الصوت المبحوح خخخخخخخخ وين راه ضرك غير كيما شفتو زرع شعرو فالترك 😂 كان هو و الخنيث تاع عبد	negative
انت قلت عاجل عجول لم تصله رسالة و انا اعطيتك شهادته بفمه و من بعد تجبدي كتاب غامل؟ وجهك صحيح حبيبنا	negative
شوف معاناة المتفرجين لخدمو يومين و راهم بطالين حاليا علابالي راكم عارفين كلش بصح لا حياة لكن تنادي	negative
الاخت عندها انفصام واقيلا \U0001fae2😂	negative
جياحة !! لوكان يكتب راجل صباح الخير واحد مايرد عليه..مجتمعنا عيان مايدصق يشوف حساب مؤنث ويتفاعل مع…	negative
والله ما علابالي بلي حطوه ههههه انشالله ميكونش نسخ لصح 👍👍	negative
تونس تتعامل مع المهاجرين نظاميين وإلا حراقة على أساس إستثمار في السندات المتنقلة تبيعها للخارج بلاش قيمة تذكر وترجع…	negative
وعلاه يهدر بالفرونسي	negative
علابالي انتم واحد هيييييييي	neutral
غير وجد وشوف امبعد شكون لي يلايمك😏	neutral
كيفاش نتوما تحطو حياتكم و ڤع واش ديرو من صباح لعشية اومبعد ناس كي يبداو يحلو ف قاعهم تقولو علاش \nKeep it privet…	negative
علابالي ديجي مخراب هذا من خلايا الماسونية الاباحية	negative
كي ماكاش بنات الفاميلية نقولولهم كي يجو يخطبو خياتكم قولو نفس الشيء	negative
علابالي شدة و تزول ، بصح ثقيلة و الله	positive
مازالت غير قادمة وقتاش توصل ههههه	neutral
خدمات فاشلة تقول عاملين علينا مزية	negative
مكانش علابالي بيها هذي تسمى خرجلو ليه	neutral
شكرا لالة ! من غير العدالة الضريبية ماكاش حلول	positive
رانا في نفس الخط\nونكره جدا كلمة قهوي\nونكره تصوار ناس فالبحر باه يضحكو بيهم\nونكره بزاااف الجهوية تاع الهم	positive
مقطع صغير لكنه رائع\nمن تصويري هذا العام \n👇👇👇👇\nولاية جيجل بالجزائر	positive
بلع و روح تلعب بعيد غامل	negative
والله تبهديلة ربي يستر نتذكر كي جا درولوا استقبال والله استغربت	negative
زعما بالك انتو إلي تغلطو😂😂	negative
امشي حتى شهر.وعلاه باش نحسدوك 🤣	negative
الحمد لله على سلامتك خويا فلاڨة، حطك فالكاجة لافرونشي 😅، انا راني نخاف نطلع، نقعد التحت برك، راني نڨصر يا خو، 👍	positive
وعلاه تعايري ولا طيحي على خاوتك !	negative
مشي كبير بزاف مزية 😂	positive
بزاف هاد خونا وصل لواحد النيفو ميمكنش	negative
خسارة عليك منها نبان قرصان منها زكارة	negative
والله شفت الفديو و قعدت نستنى فيك وقتاش تغرد 😂😂😂😂😂.. يا شمايتية انا متشمت اكثر منك ..😉	negative
علابالي راكم كامل تحوسو تعرفو تاريخ دخول المدرسي انا نقلكم علابالي وقتاش لي تحب تعرف تجي لبريفي 😂😂😂	neutral
قهوي مشتفة من kavi اي قبايلي نتاع الجبل سموا بها عند نزوحهم للعاصمة. لاعلاقة للون البشرة	negative
يخدموا وياخذوا في شهاري ماعامل علينا حد مزية	negative
انت ضل سقسي فيهم تعرفهم خير منا لا🤔	neutral
فرصة 😌😇وعلاه ضيعها 😂😂	negative
عنصرية وتسب بزاف لقبايل	negative
شكون هذي في عائلتك اعطيلي نميروا نتاعها	neutral
😱 مكانش علابالي، الحمدلله نبهتيني قبل ما نغلط غلطتك 😁	positive
نتي علابالك وانا علابالي	neutral
واااك مزية نعرفك قاله مثقف 😂	positive
😭😭😭😭😭😭😭😭مانعرت شكون تحلبلي فالدوار بلي كنت نتريني الجودو	negative
ونرجع للسؤال العويص الي معندوش حل ... \nوعلاش الليفربولي ميناقش في الكرة او باصح ميقدرش يناقشك في الكرة!؟ 🙄 \nوالله ص…	negative
مراكش غالط جيجل	positive
RT قط اختي جبرناه برا غي يرجف، واقيل ضرباته لوطو 😭😭 و درك مكانش حتى بيطري حال	negative
علابالي شدة و تزول ، بصح ثقيلة ولله	negative
كان علابالي ليفربول راح تهيج الماتش هذا 🔥 فخليت أرنولد هاو ماركا في انتظار صلاح يماركي + مدايرو كابيتان	positive
اواه علابالي 🤭😂😂	neutral
وعلاش الغش؟	negative
RT ومنيتك نطيحو نشرحو ليها خاصك شهر واقيلا😂\nمتجي حتى تشرحي ليها كلمة الأولى حتى تلف ثانية😂😂	negative
مزية داروا ماتش واحد هنا فمستغانم	positive
الخلل تقني لهدر عليه سناك \nلدرجة هذه صعيب يتحل 🙄. \nصرعونا بهذه الاولكسترا 😑. \nالفن الراقي خاطيني 😅😅	negative
الرقم هاداك لي مكتوب رقم تلفون ناناك واقيل 😆😆😆. سيري تنعسي سيري	negative
راني عايشة فالرازي و انا ماعلاباليش	negative
عادة سيئة ظهرت في هذا الصيف يروح لبحر يصورو ناس و ممبعد يدخل للتيك توك يحطو و يقول عليه قهوي باش يضحك الناس 🤮	negative
بنادم يحكيلي في حاجة و انا علابالي بيه يكذب\nوجهي:	negative
قالهم غاضتني حبيت نعاونها باش تحبس واحد الأمور كذا منا منهيه🤣🤣	negative
وعلاه نتا تدخل حرب عارف بلي تخسرها	negative
ماعلاباليش مي اول كلمة جات في راسي ،المهم ليلة سعيدة	positive
ماعلاباليش وين يديروهم علابيها	neutral
بلا مزية .. كيفاه بالغش؟\nخلاص عطيني الكونت تعهم	positive
هي بلوكاتك و انا نتبعك زكارة	negative
خيار الناس انت معليش راكي معروضة مرحبا بيك خديجة	positive
سقسي عليه تعرف؟؟	neutral
وعلاش نحبو ، وحنا حا نتفارقو	negative
ربي يحفظ العائلة الكريمة ويبارك فيهم \nعلابالي بكامل واش راك تقول وبعكم عملي نخرج بزاف بر…	positive
منيش نزوخ عليكم مي خالي مشي غامل	positive
اذا صح وش راهو يقول \nوالله غير جياحة \nنطلب من قطر ان تنزع مقعد دولة إسرائيل من الأمم المتحدة	negative
😂😂 هوما اي واحد يخمم بطريقة مغايرة يدخلوه في خانة الزندقة\nانا مرة كتبت هنا استغفر الله العظيم ، جات وحدة…	negative
انت واين عايش مازالك تتفرج في لاباطاي دالجي او هذيك وقت الاستعمار و الله غير…	negative
عقاب واقيل من نهار كمل الماتش راح ديريكت للدار و المدرب قال هذه قلة قيمة للفريق	negative
وعلاه ما بعثتوش طيارات	negative
زعما كاين منها 😂	neutral
انا كنت علابالي	positive
كالعادة الفوتوشوب هو إلي يبرد لكم قلوبكم 🤣 يعني في المواقع أما	negative
ههههههههههههههه علابالي	neutral
ماكاش منها وكان امنيتك راني نقولك اعرضني نجي انا	positive
هههههههههه غاضني مسكين\nكان غير سلفولو لويزة حنون 😁😁	negative
قريب ينحيلها رقبتها مسكينة غاضتني 😢	negative
علاه غريب بلاد كي قاع البلدان فيها لا قريسيون كول يوم الا في قطر ما يصرا والو هذيك حاجة ماعلاباليش	negative
فعلا مش باقي بزاف ونعرفوا 😂	positive
باينة حتى انا شكيت علابالي بلي تكرهني باسكو منحملهاش 😑😒😂\nقوليلها قالك شاهين قيييو و دك الفيلتر تاع الا…	negative
شكون سقسى عليك ؟ صار كنت غايب ! \nعلى سلامتك 🤲	positive
ايه علابالي حنا لي غالطين!	negative
ههههه واقيل	neutral
علابالي هذا الفيديو يعجبك🤣🤣🤣\n	positive
صراحة....لا اعرف لماذا غاضني بزاف بزاف....مانعرفوش و جامي سمعت بيه بصح غاضني بزاف بزاف	negative
وقتاش نجي نهزهم ومنين؟	neutral
والله عندك الحق جياحة هذا مكان	negative
درك نديرها زكارة	negative
اهليييييين بيك السي عاشووور 😂😂😂\nياودي علابالي لحباب يعرفو بعضاهم 🤭🤭🤭	positive
مش موالفة نهز حتى واحد غير هذي غاضتني مقابلة الشمس 💔\nواش راكي واش حوالك يا الزينة 🥰	positive
علابالي كاين منهم بزاف يلا كتروا ,10%. ركزي على الي بحبوكم راهم 90% من الجزائر	positive
هنا زعما ماعندناش كيما هاذي،،ربي يهدينا.	negative
بزاف قاع	neutral
😂😂😂 علابالي حتى نديك لفرنسا تشوف زعيتر يتعدى على…	negative
نحبك بزاف ❤️	positive
واقيلا غير انا تبانلي شاكيرا ماشي شابة	negative
هاذوك دايما مع بعض متفاهمين بصح اذا ما داروش اغاني ملاح يصرالهم كيما اينمكس ولا ماعلاباليش واش اسمهم خسارة الدراهم لي عليهم	negative
يا اخي كنبغيك بزاف	positive
واقيل دايرتني 80 سنة	neutral
كي كتب الميساج غلط في النيميرو طاح عند مرا مازالت كيف دفنو راجلها مسكينة ومازالت تقرا ميساجات التعزية في تيليفونها…	neutral
علابالي وش راك تلمح بصح نقلك عدونا الثلاثي اللدود بالتعاون مع العدو الداخلي المعروف لي…	negative
ميزيريا وتحيا كاش حاجة 🤷	negative
سميتك وصال\nبنت سكيكدة\nعمرك واحد وعشرين واقيلا\nتحبي تصوري\nمعروفة بالنقطة	neutral
لا نريدكم اخطونا اخطونا اخطونا اخطونا 🇩🇿🇩🇿🇵🇸🇪🇭🇩🇿🇩🇿	negative
ماشي كلشي واقيل كاين للي كيقولها اظن مسألة ولف وصاف	neutral
وردي مش قهوي	neutral
شمعنتها انت ول حالة!!!!!!\nكيفاش تنجم تبرر انسان شد ظفلة بسيف عليها و احسبها كيما frigidaire ولا gaz \nوقتاش نتعلمو و…	negative
RT شريكه في الجريمة فاق ولو بصفة متأخرة وأنت وقتاش يا دغفة يا مدك 😀	negative
يقول المثل :\nسقسي المجرب و ما تسقسيش الطبيب 😌	neutral
صح ثقيل بزاف لهذا لازم تنوضوني غير بالسياسة 🤣🤣🤣	negative
واه نيشان والله الا عندك الصح 👍🏻	positive
يكفي بها مزية 🤲🌷	positive
ايه توحشنا يوفي مثلا 😭\nتا دورتموند واقيلا مابيهاش	negative
هههه امبعد تعرفي قيمتو 💗🦋	neutral
علابالي بلي مرتك خير منها	positive
غير ما ترقدينيش .\nاحكي كلش . و الله ماني شاك فيك \nعلابالي بلي علابالك درك راني sure	neutral
هههههههههههههه علابالي قلبك صافي	positive
علابالي يحب يزعفني 😄	positive
لا لا معانديش مزية\nنراعيو بعضنا عادي🙂🙂	positive
""MAMA""مواطن: اللهجة تاع بكري راحت.. ماكاش لي يقول ""يمّا"" ولاو يقولو	neutral
مسيو لو بغيزيدون🤥\nياودي يا الشوهادا ياودي\n😂😂😂😂😂\n	neutral
بغير مزية هذي ربي يهديك	positive
كنت ديزاكتيفيت تويتر من تلفون ! مي ماعليش عااودت طلعتو \nعيطتلي دورك ولية من وهران قاتلي صبت نيميروك عند راجلي و كات…	negative
كاش واحد قال حاجة ضحكتهم في اللحظة هاديك بركاونا من الدراما يرحم والديكم	negative
ماكاش الماء، الناس ولات تخسر باطل، ١٠٠م تسقام ١٠٠مليون و ما يلقاوش الماء.	negative
بعض الناس تفكر انو انا نبكي كي نخسرهم باش تفهمو اكبر حاجة غاضتني خسرتها هي شعري والباقي 🖕	negative
معليش ختيتو .. \nبلا مزيه .. حفدك ربي صارون 🤲🌹	positive
عندنا فيلا باالملايير في وسط جيجل بعرقنا وعرق مهنة الماصو لتحكي عليه ونزيدلك فيلا…	positive
مليح مليح ،،، حتى أنا حبستهم مدة عام و زيادة مي دروك وليت نشربهم خطرة على خطرة ، ماكاش كيما الماء سيرتو الصباح على الريق	positive
ههههههه ونتا قاعد في إسبانيا وتكتب بالفرنسية وتحدثني عن كلاب فرنسا يا جحش ؟ واش من ر…	negative
واه حملاوي.. انا ما كاش علابالي مريم	neutral
البارح شفت وحد الانسان مسكين غاضني بايت برا ضربتو بحجرة لراس باش يبات فسبيطار الله يقدرنا على فعل الخير 🥺💔😞	negative
هديك لو كنت خليجي او مشرقي لكن مدامك من دولة مجاورة لم أظن أن مفهومها يختلف كل هذا الاختلاف يا خو المهم…	neutral
حمدلله بصح ماكانش علابالي بلي يدير هكذاك كنت نحوس نشربوو مزيا قولتيلي	positive
واقيل غير أنا اللي نعوم هاك 🤦\u200d♂️🤦\u200d♂️	negative
ان شهد انك صدقت فريق مايسوي شي مخدوم من كل شي مثل الي علابالي😂	negative
مهوش اسمي ياك هادا وعلاه طاوس من بين أسماء كل واسمي مشي طاوس 🙂	neutral
واقيلا حتى انت على سبة انيت هههههههه	neutral
وي الجزائر تاعكم صح غير بالهدرة برك نسييت إيه ماكانش علابالي بالي الملك تاعكم يحكم ولا يملك	negative
راني متعجب من واحد ناس روسهم مكعبة كان يسب يقول ماكانش المتريال وكي تمت السيطرة على 118 حريقة في أقل	negative
انا ني نرقد بلا ما نشارجي تيليفوني حتى امبعد تجي وحدة تقلي تبدلتي؛ علاه ماكيش تسقسي عليا 🙂	negative
وعلاه يقولك فهم السؤال نصف الجواب . \nالخاوة عندهم معيار النجاح هي عوامل النجاح. وداخلينها يجاوبو Gوش دروات.	neutral
الثقة بالحب اني نغيب عليك ونرقد\nوانا علابالي بلي ماراح دير حتى ❤️\u200d🩹\nحاجة تخذلني ورا قلبي حتى لوكان\nيمدولك الدنيا كاملة.... 💔🥺🥀	positive
علابالي كاين امام \nصوفي و كاين اباضي و كاين سلفي \nكل واحد يمث…	neutral
