tweet	label
ok a chikwembo cha swi vona	positive
Auxeni Madala U bom.	positive
Mom of kids Mamana wa vanana	positive
Ni vhona bemğŸ˜‚ğŸ˜‚ğŸ˜‚	positive
mina nipfukile mara anisya helo naha yimela axikongelo xa bava MALEYANE nitatua ku ku djiwa yini atiheleneğŸ˜	positive
#Topic i vona hiku na loku mihlangana anipfuxeliwi, niblockiwa ka ti social ntwrk	negative
U gama u Kuma 2 valores	negative
": Na vadwa, ani sida, a nina nuna, nita feva ku kundza, ka hissa, ka titimela, hissa, ndzeni, handle, tilhanpfe"ğŸ™ˆğŸ™‰ğŸ™‰	neutral
Ya, no Xipamanine	positive
Mina nawena, Wena namina, #LovarÃ‰Nice utatwa kunandzika! (4Ã—)	positive
Wa txintxa ğŸ˜‚ğŸ˜‚ğŸ˜‚ğŸ˜‚ğŸ˜‚ğŸ¤£ğŸ¤£	neutral
comekiÃ©ee ğŸ˜‚ğŸ™ŒğŸ½ğŸ”¥ Ni speed, cumbi sfwayantswa?	positive
": Auxeni, inlhikani,li xile, ku ndjani, unga ni nhenhentsi, ni bihile, u shonguile, wa nunwa, a ni pfukanga kwatsi."ğŸ˜¹ğŸ˜¹ğŸ˜¹ğŸ™ˆğŸ™‰ğŸ™Š	positive
Auxene va makwezu.	positive
" Mina nawena, wena namina, #LovarÃ‰Nice, utatwa kunandzika ! "	positive
Famba ti kundza invejosa ğŸ¤£	negative
Wa nsila lweyii. ğŸ˜ª Damnn	negative
Fvck U PhağŸ¤£	negative
WA SWI TIVA BRODIğŸ’ª	positive
Swimbenhane wa dja ku ni hembissa ja ğŸ˜‚ğŸ˜‚ğŸ˜‚ğŸ˜‚ğŸ˜‚ğŸ˜‚	negative
Nisuka xokwe sweswi tani bazara ka xingangi agora	positive
Ni sungulekile khale mfana ğŸ˜‚	positive
Mabermuda- matilho*xa wula wula ğŸ¶ğŸ”¥ğŸ”¥	neutral
nile guija ni tlangela birthday ya mina	positive
kassi wa tsonana?	negative
Ba Teka teka teka hi mani Mulato/ Ba Teka Teka Teka Hi mani Mulungo/ Ba Teka Teka Teka Hi mani Mbanyanga #XilhaulaMani	neutral
Xanga xa malembe. Xita vamba Xita buya ğŸ˜ğŸ¤ğŸ‘Œ	neutral
lol&gt&gt; shii manoo#slowly: wa biwa	negative
Hambi honi nhenha kassi wani nhenha wayi uni nhenha ğŸ¶ Mavelevele Hustler ğŸ”¥	negative
leswi ni swi vhonaka mine	positive
KI estÃ¡ a criar um Vuku Vuku grande sabe	negative
AWENAAH. U mukulu. ğŸ˜‚	positive
Kuna Xukela, la ka mina kuna Xukela.kuna Xukela, lÃ¡ ka mina kuna Xukela! ğŸ”ˆğŸ”‰ğŸ”‰ğŸ”‰ğŸ”ŠğŸ”ŠğŸ”ŠğŸ”ŠğŸ”ŠğŸ”Š	neutral
Tem ni dondza primeiro para ni khanela	positive
Ih ni livrari, yu.	negative
Dzixile ohine ku pfuka	positive
sister lowi hikuya himina angatekiwange end ana vana vanarho va papa vo habana end angangeni kereka nabiya wa phuza	negative
Futsek wena eh	negative
U kundzekiwile bai.	negative
"Estrela we! U randza mane, ku mina na yena?"	neutral
HAHAHAHA FUTSEKA WENA.	negative
Hlula mine U hlula tingonyamo U ta teka tiko, I dzaco!	positive
#DesafiodeDezDias siku dza wu Muni	positive
Va delela! Ntlha	negative
sim ğŸ™ˆ Teka famba	positive
Tsek wena satan	negative
he uncle miri I birthday ya nwina namutlha?	positive
A hombe. Khanimambo. Ho yini?	positive
ni nga dlawi ğŸ˜‚ğŸ˜‚ğŸ˜‚ğŸ˜‚ğŸ˜‚ğŸ˜‚	negative
Ntaku Greeka wena	negative
MIta kateka loko va mi hlekula, nwina va nge mi bihili miri vana va xikwembu, tsakani hiswiswo hikuva hakelo yanwina mi tayikuma ematilweni	positive
Nwana Mutxangane i mutxangane em Praia do Bilene	positive
Definetly GOATS Alexandre Langa - Rosa Maria Pedro Langa - Mamba ya Malepfu Hortencio Langa - Lirandzu	positive
wena kumele uhambisweâ€¦ğŸ¤ğŸ¾	neutral
Loko u va kuma va tlanga, tlanga nawenaweğŸµ Loko u va kuma va tirha, tirha nawenaweğŸµ Loku u va kuma va phusa.ğŸµ U nga kalavalewi hi vanghano mani	positive
ni khensile nd ntava nayena mundzuku	positive
I luh ya papi	positive
Eh, eh, eh. Ni livrari	negative
Wa biwa lweiğŸ˜‚	negative
ğŸ˜‚ğŸ˜‚ğŸ˜‚ğŸ˜‚ğŸ™ŒğŸ½ ni livrari. Txau	negative
U la kuta ka mina Ungati na usiku U zama zama kuni phazamisa . U la ku nivuyisela a gono ni meticali	negative
pfuxa: 1 Rafael Ndlhovu, ka Mavodze 2 Antoni Nyathi la Pitori 3 Cuvuka Valoyi ka Xisungele I ADOLFO KHOSA LA MOZ. KA KHUBU.	neutral
Thnx God mozambique shutdown #tag Nghena.na khensa ku tlakuriwa vanhu va mozambique Moamba, Maputo, Mozambique	positive
Teka Famba ou Gina	neutral
Vatlanga ha lonağŸ˜‚ğŸ˜‚ğŸ˜‚	neutral
Mas ni yetxi yini? ğŸ˜‚ğŸ˜‚ğŸ˜‚ Unga ni loyissiğŸ˜‚ğŸ˜‚ğŸ˜‚	negative
bona kuri wendle yini munu waxikwembu.ğŸ˜–ğŸ¤£	neutral
Fissekane ni Barcelona yenu ğŸ˜‚ğŸ˜‚ğŸ˜‚ğŸ˜‚ #HallaMadid ğŸ˜ğŸ˜ğŸ˜	negative
Teka Famba, Papu	positive
â€œKasse mamana ya wena ii herioaâ€ğŸ˜­ğŸ˜­ğŸ˜¹	negative
#PhaphamanaMunghana Community weeâ— Avuxeni vanhu vamisava. Woza friday, hlayisekani miyingiseri #phaphamanamunghanalonene. Ahitireni hita hola male yosaseka. ixiGwambana kusuka la a Gwambeland, vana va Gwambe na Dzavale.	positive
December ni tirhisi leswo tala ntaswi vona January Cidade De Chokwe	positive
Wa bomba Mchangani Ni bombisa ku kuma Vodacom	positive
ğŸ˜‚ğŸ˜‚ğŸ˜‚ğŸ˜‚ğŸ˜‚ğŸ˜‚ğŸ˜‚ lo gaa ni kume vanwani vantswa	neutral
Round 2 ya nili kwala a Mozambique seni fikile a Maputo	neutral
ğŸ˜‚ğŸ˜‚ğŸ˜‚ğŸ˜‚ mwine mu tÃ¡ biwa jÃ¡. Ma ni lhekissa ğŸ˜‚ğŸ˜‚ğŸ˜‚ğŸ˜‚ğŸ˜‚ğŸ˜‚ğŸ˜‚ğŸ˜‚ğŸ˜‚ğŸ˜‚ğŸ˜‚ğŸ˜‚ğŸ˜‚ğŸ˜‚ğŸ˜‚	negative
Maji angana xi baciana lweiyo?	neutral
Aloku niku im ğŸ˜› ğŸ‘Š_/ \_ğŸ‘Š ( . ) ğŸ† ğŸ‘– Ya ba buluko	neutral
swilo swa konağŸ˜‚ğŸ˜‚ğŸ˜‚ğŸ˜‚ hi voice ya Connizer	neutral
Ka dlhiwa maleğŸ˜‹ğŸ˜‹	positive
Ximixweni, Madanbveni, ni Usiku #SikuNiSiku	positive
Streaming live ni ri kwala Maputo. Bondia &amp;	neutral
Ceh Ina ka! I para hi ku yini?	negative
Ina ku jika jika ntsena	negative
Ali exageram ih	negative
Va makwerhu, a mungoyothaya. em Tomanine-GuijÃ¡, Gaza, MoÃ§ambique	neutral
Wa vurisa mfowethu.	neutral
Ikhali mina ni zunga waku djokuni tolovela - sg	negative
": AHAHAHAHAHAHA waHidanissaa N*sia :D :D"oh ih Xixa hahahahhaha	negative
Na Unitiva tem OpiumğŸ¥º	negative
AUXENE. Moh ini ku pfuka?	positive
Ya ya ya! magoanine	neutral
Namuntlha nada baiye, a xirhame ci demanji	negative
Yuh. VÃ¡ djula ku ih hlongola ka tiku ledzi. Ih dhlawileh	negative
Ahahahahaha ih ya ya ya	neutral
Mina nile ntirhweni la Mozambique ka Khubu	positive
ğŸ˜­ğŸ˜­ ni caralile boy	negative
Nina wena kola xokwe Mozambique nilo gee 810dstv #53yrs	positive
Moya wanga u ndzunissa Hosi A moya wanga Hosi Hosi Hosi Aku ndunissağŸ’ƒğŸ’ƒğŸ’ƒ	positive
loko va yi rhanza cricket na	positive
Kasi swa vava ku tsikiwa ğŸ˜­ Cidade De Chokwe	negative
ğŸ˜¹ğŸ˜¹ğŸ˜¹ğŸ˜¹ ih fswona ndwena, A ciku para vhaku biya dzi ta tlassa	positive
hee wenna ni tsiki	negative
hii wa ni xicha :-(	negative
WuaağŸ˜… swa ma SUPERA PATRICK ani tendereğŸ˜…	negative
Na hanya. Aswina ku kazata.	positive
ni khome buti	negative
Yuh. MamÃ£. A ni ku lavi minağŸ•ºğŸ¿	negative
Loku u navela Ku tissunga, tissungueğŸ•³ï¸	negative
Wa famba o duwuliwa	negative
Famba ti gumula hi parede	negative
Futseka wena. Famba ti ginha hi xpinhosa	negative
Messi Ã© xipoko a taku dhlaya iku bela bem	positive
Himina muyivi WA botija ğŸ˜‚ğŸ˜‚ğŸ˜‚ğŸ˜‚ğŸ˜‚	negative
Manter estrada que estamos a pagar?ğŸ˜‚ğŸ˜‚ munga hilhupi	negative
A xizame xo kwapa hiğŸ¥¶	negative
Nada a swi twsisiseke	negative
Auxeni Va Jessica ni Va Jessico	positive
wa biwa wene:-D	negative
Famba ni ma Range ya wena ğŸ˜‚ğŸ˜‚ğŸ˜‚ğŸ˜‚	negative
I tinholuene a xwi Dari	negative
Khanimambo ğŸ™ğŸ¾. Hi yini kupfhuka?	positive
Auxenee Tek, hoyinee ku phukaa?	positive
A Xikwembo A Xi Ku Katekisse ğŸ™ğŸ™ğŸ™	positive
Rendes Xikento ihğŸ˜‚	positive
Essa noite ? Swa hila	negative
15' to 326Twhii, ni mikuma kahle nirila Mozambique ka KHUBU. Adolfo Corsa Lweyi#tagXMA14	neutral
A quiet place 2. Here Hina ya famba	positive
Hi pfuki bem, a whana wa tlhangua akuna ku karata, whina ke?	positive
Para depois anga nandzikeğŸ—‘ğŸ™†ğŸ½â€â™€ï¸ leswo swa ma foto hum	negative
YABA BULUKU A FAZER HISTÃ“RIA	positive
Ohh hosy yanga dzi xurisse hi moya waku dzi tiya dlhelene yaku â™¥ï¸ Saudades.	positive
ni yingisele niri kola Mocambique ka chokwe thwii	positive
Kea tshosetsa mara o ke wena ğŸ¤£ğŸ¤£ğŸ¤£ğŸ¤£	neutral
Wena unga zuzumeli, ni dzweli kumbe ni ta xava kwini a ma xiluva ntsem.	positive
Wena wa xitiva	positive
Nitafa na wena murandziwa Te amo Te amo Nitafa na wena murandziwa Te amo Te amo #Vibes	positive
#Topic akuna ku hambana vahaxi na hlonge yinwani ntsena i respect.hi bula navona ive hi share navona ka ti social	neutral
"Siku dza mundzuku adzitiviwi hi munhu, sÃª swayampsa utidondzela weena, ROSALINAA" OuÃ§a #Rosalina de Keyce no #SoundCloud	positive
Hi pfhukile. A va tsongwana va thlanga. Khanimambo. Ho yini kupfhuka?	positive
Lol tavuya ka mana Thembi hahahaha aku tleleki meu irmao	neutral
Ah bro ya. ğŸ˜‚	positive
Nako male ya mu phuntissa	negative
kambe ira mani risimu leri hi sungulaka awara ya 7 naa. Rini tsakisa ngopfu vakaxi va mina. Rixile.	positive
nitaku panhula hi xikwe xa tiro lÃ¡ ğŸ˜‚ğŸ˜‚	negative
Swi mbeni. Mas vale u mielaa	negative
Hi Ta Hambana Hi Ma Central ğŸ˜­ğŸ˜­	negative
#HHW Sesi famba uya vonana na papa face to face uhlamusela mhaka ya wena papa va rhelela moya	negative
unga ni singuite ni mumu lÃ³	negative
Namina one day vata ni posta va beka mbilu â¤ï¸ğŸ˜©	positive
Wa biwa wene	negative
Xikwembo Xanga HaleluiağŸ™ŒğŸ¾, Hi Cussa Hina JÃ¡ Ya BuyağŸ‡²ğŸ‡¿ğŸŒ	positive
Na hina hi gud. , nambi yi txonille hi rait. ğŸ”ŠğŸ”ŠğŸ‡²ğŸ‡¿	positive
Rixile he skhokho, niku kuma kahle nirila ka ka Ncai Ncai e Mozambique! I ADOLFO MIMBIRE LA MOZ KA KHUBU.	neutral
Ku njhani ni nghena kola chokwe	positive
A mbangui mu dzahaka Yowe yowe	negative
Nasty C ih âœ¨ğŸ™ŒğŸ”¥ğŸ”¥ğŸ”¥ğŸ”¥	neutral
Maputo ka hisa sorry la	negative
Hi pfukile anti wena, vÃ¡ hanha kaya?	positive
nimi ingisele niri ka Chokwe Gaza Mozambique via	positive
Sono. U kwini	negative
Mozambique is burning #tag Nghena mintirho wa vulavula Chicualacuala District	neutral
ğŸ˜‚ğŸ˜‚ğŸ˜‚ğŸ˜‚ğŸ˜‚ğŸ˜‚ mita phaka draw Ku tava lucky	positive
Swiyimbeleri ahi yeni . miva byela ku hina hi tiva ndlela(senya retla patela) Mozambique	neutral
Ya ba buluku. Tsokaa ğŸ•ºğŸ¿	positive
mara dj unjani wena hiiÃ¬ğŸ˜‚ğŸ˜‚ğŸ˜‚ğŸ˜‚ğŸ˜‚	neutral
Xitombo xa wanku	negative
dzixilela wena mufoto ho ini hi ku pfuka?	positive
Unga hi nhenhentsi wena	negative
Na hanya. Akuna swa ku kazata. A va tsongwana va thlanga.	positive
Swi dja kufembiwa. ğŸ˜‚ğŸ˜‚ğŸ˜‚ğŸ˜‚	negative
Dzi xile va makwezo !	positive
U womu sau?	neutral
Ku gama ku humelela Mabandido ğŸ˜­	negative
A vavasati ya tswira a tibi bem hi nhloko	negative
A makhessemussi nkata ni ma lua de mel hitada xikamwe ungatxavi nkata hikussa sse hi txadile	positive
Banani MÃ¡ Voko, Assistam In Loko #8ou80EP	positive
Bom rapper. A gama ku biwa ğŸ˜­	negative
ğŸ˜‚ğŸ˜‚ Conforme Me Swi Vhonaka Isto Requer Uma Conxienxia e Idade Elevada!	neutral
rixile he skhokho, mina niku kuma hi app yinwani hambi leswi yi pfaku yi tsema tsema nina nwina nirila Mozambique ka Ncai-Ncai hi ntirho.	negative
Xtombo xa ngwako oskhâ€™an test us papÃ¡, donâ€™t play like that	negative
"Ah wa wassate waku shonga, hunghÃª wa whettii wena."	positive
Ni pfhukile. Khanimambo.	positive
Barcelona ( Loko ni file mungane rilane)	negative
Refiller Boy- hosi yamo ganga ğŸ˜¹ğŸ˜¹ğŸ˜¹ğŸ˜¹ğŸ˜¹ğŸ˜¹ğŸ˜¹ğŸ˜¹ğŸ˜¹ğŸ˜¹ğŸ˜¹ğŸ˜¹	neutral
Va yi kwine a vangana va wena â¤ï¸ Vila olimpica do Zimpeto	neutral
Famba uya ti fassağŸ˜¤	negative
Varikufanirwa Ku adviser ani.	neutral
dzipelile u kone fanhana?	positive
#HHW Sesi byela va malume se vona vata hlamusela papa ku wa kuna dzovolo wa yena	positive
Famba te kundza PAH. Hahahahahahahahah	negative
Mina Ni Randza Wenah X Mexe O Esqueleto #DjAlvinALutaContinua	positive
Wena u txela mate.	negative
ni bom Wena ke	positive
Niku yingiseli nile xokwe Mozambique nilo gee kola hansi ka nsinya wa nkanyi 810dstv	positive
Ma sweet lady ma talil Ma sweet lady ma talil Mina ni be dji utomi Ni funga kufa niku hanhana I will always love you Ma talil	positive
Wa hi hemba mane ğŸ˜ª	negative
Nawene tem que o tsika madururo u pimissa nhana	negative
U tsama u ui vona a mbongolo yi nga xidjana? ğŸ¤” Ih leyi Lani ğŸ˜‚ğŸ˜‚	negative
mina nitsakile swinene Gingirikani munu wa tshitsha	positive
Mara dj wa marhandza mavhavha	neutral
Swa fana hi tafa	negative
#HistoricEndtimeRevival Celebrando o Senhor MIKULUNGUANA KA YESU ALILILILILILILILILI ALILILILILILILILILI ALILILILILILILILILI ALILILILILILILILILI	positive
Vungani ka story ko timve ğŸ˜‚ğŸ˜‚	positive
Auxene. Mo yini ku pfuka? #Acredita	positive
kasse u txava hinni	neutral
Swili leswi u tivaka nguiza Hina ku lava hi nyombela?	neutral
HÃ´ yini, hosi ya ma rima?	positive
Nidzumba nanwina ka mungana	neutral
Ni bha ma fato ni ma Air Force	positive
Mmm. Swa hombÃ©. Ni pfhukile. Khanimambo	positive
Ih Rihanna djon ğŸ˜­ğŸ˜­â¤	neutral
#SabedoriaLocal: "Leswi munga ka swona swi fana ni kuya rhinga Nyanga kumbe ya tirha" TI VONELE NGOZI MADALA! #nDota! #DÃ¡lvioMachava!	negative
He Kombela ntirhu ta replace rendani ndou ani maphepha hungu yari iya Ka pirates ğŸ˜‚ğŸ˜‚ğŸ˜‚	neutral
â€œWa Vizinhouu Nikonbela Ko Loyiwaaâ€	negative
Wa swi tivelağŸ‘ŒğŸ‘ŒğŸ˜‚ğŸ˜‚ğŸ˜‚ğŸ˜‚ğŸ˜‚	positive
Karingana wa karingana-JosÃ© Craveirinha	positive
Kassi hi wena Lolita ğŸ˜‚ğŸ˜‚ğŸ˜‚	positive
Muhaxi lwiya ho hatlisela ngopfu loko a haxa hi wini wakona left or right?	positive
Nami hoyozela vahaxi vamina va migingiriko na tsemba swaku muyetlhele kalhe ami bedweniğŸ˜‚ğŸ˜‚ğŸ˜‚loko mu suka kağŸ‘‰ toloğŸ™ˆ	positive
epa, a swi dare	negative
na khensa bra ya Mina	positive
Ni randza nyama	positive
niku khoma nile xokwe 810dstv	neutral
Kota Yasser ya ya ğŸ¤£	positive
Usho wena neh ğŸ˜‚ğŸ˜‚	positive
Mina ni pimisa ku tasi. O desesperado=Cliente	neutral
Ni pfhukile. Ho yini kupfhuka?	positive
Oh Ok xÃ´ niku txiketile	negative
Tivha yini hi paixao wenaa	negative
swa kahle leswo	positive
A xitombo xa nandzika	positive
Malome u ndjane?	positive
Swa yentxeka nÃ£o tÃ¡ nada nice ğŸ˜­ğŸ’€	negative
Aweh. A tihlu ğŸ˜­	negative
A macena mÃ¡ loukizzy muzaia ğŸ™‚	neutral
ğŸ˜± oh hosi yanga ğŸ™†	negative
ya pokehh o xpantuu. #l0lzz	negative
Na hanya. Ho yini?	positive
Ni dzinginika na nsati wamina nthabiseng mashaba ka xokwe nwana mina inocente mathonsi na conny mathonsi ka xokwe .	neutral
And u tah swi kota	positive
Hi maka Ruy ğŸ˜‚	negative
xitombo xa ngwako	negative
U tah yi phuza impala ğŸ˜¢	positive
Va Tsike bai.	negative
Nikensa Yesu Ã© ğŸ”¥	positive
Wa pupuruka wena.	negative
pandzela ntsandza wa majaha Nwana I tiva hi Mutswari Baji ra makhelwani wari ambala ritlhelaâ€¦	neutral
â€œXitombo xa zaidaâ€	negative
A ta ti nhelağŸ˜‚	negative
Teka Famba Ya Man . Te amo ğŸ˜»	positive
A xitilo xa bobi hi xi?	neutral
wandilahla hla wena shm	neutral
": ğŸ˜‚ğŸ˜‚ğŸ˜‚ğŸ˜‚ğŸ˜‚ pvt"unga ni viajari wena txela nhama lanu	positive
valeu meu cota, a niku hi yessu hi kakunene	positive
niku yingiseli nile xokwe Mozambique 810dstv	positive
ğŸ˜‚ğŸ˜‚ğŸ˜‚ğŸ¤£ Wa hlanya wena Kea bona.	negative
La ka mina ku dyiwa ti coconut ğŸ¥¥. Maputo, Mozambique	positive
hi nga ribali futhi na mhaka leya Ku dlaya vanhu va ti albino	negative
Wayi vona manica ya nyuwani	positive
Hile ku tlangeni na vanwan Praia do Bilene	positive
loko dj momu siya yexe sikurinwe lani ka vangarikona na na buti anga swihaxa hkwaswo loyi wa dj atlhela abala nitilhoko mhaka ta mahungoğŸ˜‚ğŸ˜‚ğŸ˜‚ğŸ˜‚ğŸ˜‚ğŸ˜‚ğŸ˜‚	positive
Unga lhai, lava vÃ¡ lhayaka swaku kuni ma gerador nem a vÃ¡ kutive Albasine cola ka maputsu, ambi bobole loko kungana placa ava ku tive, ja vÃ¡ tiva ma gerador ya tiko, hewenou, hambe male kona ma gerador a mana gasolina pru falta ya orÃ§amento.	negative
minga valavuli hi mbilu ya mina ya vava vahaxi.	negative
Hi ta kunhemela le titxini ikussa ya ku randza na Hina hÃ¡ kuxuva makhero	positive
Ku saseka naku faneriwa swa wena keep it up	positive
Siku dza namuhla dzi kathekilÃª ğŸ•ºğŸ¿	positive
Tiva Hini hi khu fassa ğŸ˜¡	negative
A u tivi ntxumu	negative
Bwakakaka ni tsike	negative
ğŸ˜€ğŸ˜€ğŸ˜€ Acha tariqa hai lene ka	neutral
Na hanha. Aswina ku kazata. A vatsonguana wo thlanga.	positive
#Gingirikani swiya hiko tembisana ka vona e ku sunguleni	neutral
If phfukilÃ©. Ah ih se vona swa ku kazata. Mwina kÃ©	positive
MMA IH PRIGOZO MANJI ğŸ˜‚ğŸ˜‚ğŸ™†	negative
Wena awu ni tendere nkata '8)	negative
A ku khala ğŸ‘€. Ama saudade ğŸ˜¿ğŸ™Œ	positive
A LOKO NIKU HIIN	neutral
Mr Bow - Ni tafa na wena	positive
swivula kurhi xithembiso xa vona axika hetisekanga hikuva a xihlangi hixona xi tiyisaka a varadzane aka rixaka hambi kurhi mungangeni akurhi adam siolhe la chibuto mozambique	positive
#HHW zama kuti hlanganisa na yena chomi ya wena face to face unwi tsunduxa hi xikweleti don't give up	positive
Utomi Nzanga Za Ku Tsakissa #PretoDeMoz #Enjoying The Life em Maputo, Mozambique	positive
Niku zwÃª tititi, a ni ngueni mina ! ğŸ‘€ğŸ™Œ	negative
Aha swa mbangue. Tsala swi mbeni. Hloko ya pao	negative
Conforme mo swi vonaka ğŸ˜¹ğŸ˜¹ğŸ˜¹âœŒ	neutral
sala kata ha to	neutral
": Blake me paga hahahahahahahahahahahahaha ih" â¤	positive
wasvivona svosvi, kopfukiwa. Hikhanga hi svihlaya lesvi khaale.	neutral
Va mu tlelile pah ğŸ˜­ğŸ˜­ğŸ˜­ tlelaa!	negative
U saize wa mbedo wa mina* ğŸ•ºğŸ½ğŸ”¥	positive
A vhula vhula ngopfu problema	negative
Niku yingiseli nile xokwe Mozambique sesi thembzana	positive
ku famba yin la Africa do sul?	neutral
Lano a moya wa paraia inkwawu hu fambela kolomo, entÃ£o sÃ³ podi u ti lunguissela bavou, xi ta Teka xi tereto	neutral
muhaxi mbilo yamina ya vava hi Chiefs.eshh niri Khombomuni-Mozambique	negative
Yehova Hi Murussi Wa Mina ğŸ’â¤ Marracuene	positive
Nem Ã© WOW. kasi a ni ya kwini	negative
Swi helile swa ma pank, finish ğŸ˜¹ğŸ˜‚ğŸ˜‚âœŒ	positive
Famba ti kundza.	negative
Edjoh. a gaju yini vhoku pah ğŸ˜‚ğŸ˜‚ğŸ˜‚	positive
Wa Loya wene ğŸ˜‚ğŸ˜‚ğŸ˜† hi tsiki	negative
Vo hi fridjela Wenou, vo hi komba fswaku a ndlela ya sathana ya tika, ka hissa ala ansi, jÃ¡ wena langa kumbe u lava kuhissa loko ou kumbe pradise.	neutral
Aah futsek wena	negative
Ya disko funk ğŸ˜‚	positive
makwenu wa wena?	neutral
Vamos demostrar solidariedade masculina! A XI pfutseki	negative
entÃ£o ungah ni trapalhari wena pah.	negative
Auxeni .mho wine ku phuka	positive
Se Yaba Buluku Leyi	positive
Uta ni dhlaya	negative
" a xa Lissima Ih Ku Ti Beka Hansi "	positive
ğŸ˜‚ğŸ˜‚ğŸ˜‚ U ya kwini	positive
Unga andlhali lÃ¡ BAZARA mintxumu ya caia.ğŸ˜‚ğŸ¤£ğŸ¤£ğŸ¤£ğŸ¤£	neutral
I'd sing "Hita famba moyeni nkathanga".ğŸ¤£	positive
Madala lweyi namufeva, wativa stereka!	positive
Utd wa biwaa ğŸ˜¹ğŸ˜¹ğŸ˜¹ğŸ˜¹ğŸ‘ğŸ¼	negative
kasi Mina se nilo onha yini Ti tweets ta Mina amihlayi vahaxi.	neutral
Nkhosi, Dlamini Wena WeKunene. Thank you Cuzâ¤ï¸	positive
Makwezu niko kombelela ka Xikwembu a minkateko ni hinkwafswo fi ku fanelaka, ti male, ma gudi laifi, ni mintirho yo tala. parabenja ğŸŠğŸ‰ğŸ‚ğŸğŸˆ ğŸ‚	positive
Mu xava kwini a nyama ya homu?	positive
A vavasati va ma mecha ugue vÃ¡ heti wena.	positive
kannimambo, ni tsakÃª swi nene	positive
U La Ku Nitxintxa My Baby! U La Ku Nitxintxa My Baby!	negative
Timale Timale hi da ni mabitch ğŸµğŸµ	positive
Ih piki sixti i dii nirmil. Ftsekee. Maluuco	negative
Niku swÃª tititi ğŸ˜‚ğŸ˜‚ğŸ˜‚ğŸ™†	neutral
Siku ni Siku	positive
Swi txiki leswo. Os dois se txendam aqui	neutral
sangula ku switwa, ti vutisa ku va ngave va endle yin xakahle namuthla	negative
dezember time . . Ku ta fiwa	positive
Hibha fotxolo khuza ku huma no lithilu	positive
A mbilo yanga cho ba	positive
#PhaphamanaMunghana na xipano xa phaphama inkomu swinene, ahitireni hita hola male yosaseka. Siku ra kahle na kava engiserhi. IxiGwambana eGwambeland.	positive
Ni pfhukile. Akuna swa ku kazata. Ho yini kupfhuka?	positive
Hi ta ya ka wutomi !	neutral
Fambane mi te kundza nwine ok ? Estudos swa kho vha hambi ka kehele dza mani?	negative
Hee . ha ni wa lewso mina ğŸ˜­ğŸ˜­ğŸ˜­ğŸ˜­	negative
Cinderela wa mina I love u babe â™ªğŸ’ƒ	positive
Niku khoma nile xokwe Mozambique	neutral
A xilungu xakarata. ğŸ¤¦ğŸ¾	negative
Aweenn .Ka hissah. nem haku sebaa doze	negative
se buti Brian nwana wa hale ka hina u kahle ngopfu ka ku khenya xi Portuguese	negative
Hunga kwati vavito ğŸ˜ğŸ˜ Ni dzivalele ğŸ˜ğŸ™ğŸ˜‚	negative
Wasvitiva a kutsala hixitsangana ?	neutral
Fisseke wena pah	negative
hi pfukili bem Doutor wena ke	positive
Hahahah swa nsila sÃ³ ğŸ˜‚ğŸ˜‚ğŸ˜‚ğŸ˜‚	negative
Nikubula Rosinha wa minağŸ˜‚	positive
Loku u khaya nkakağŸ˜‚ğŸ˜‚ğŸ˜‚ğŸ˜‚u tlanga hii posiÃ§Ã£o	positive
Dzi Xile Na voz de Kanye West	positive
hina hi hanya mahala ka jesu ğŸ¤©ğŸ¤©ğŸ¤©	positive
Wa switiva papa!	neutral
Hi ku pfinha, va hi sola	negative
Marido: (apÃ³s ter pedido chÃ¡ hÃ¡ uma hora) serÃ¡ que ni ta kweva a chana namutla. Esposa: u ta kweva boy, aliÃ¡s boss. Marido: hi mani boy? Esposa: ni phazamile, hi wena boss. Assim estamos na esquadra ğŸ¤·ğŸ½â€â™‚ï¸	negative
Ni pfukile kwatsi.	positive
Xa gwirha Hii a XI vojani	negative
wa gwira weni pa	negative
Conforme mu swi vonakağŸ˜‚ğŸ˜‚	neutral
mara tinsimo ta xitsonga ta tsakisa niku yingiseli nile xokwe Mozambique	positive
Vha ta dlayağŸ˜­	negative
Parceiro//a Novas mÃºsicas 01.HOSI HI PFUNI ğŸ”¥ 02.NINA XILONDZA MBILWINIğŸ”¥ 03.HOSI XIKWEMBO ğŸ”¥ WhatsApp +258866753098	positive
Ni humule ha hombe muzandziwa ğŸŒŠğŸŒŠ	positive
Niku vonile na nifamba hi movha ani jahile niku vone ka nkuna ka palmeri	neutral
wa khala pah	positive
Hita khandziya ti bus ta ANC hi mbali swi khipa SWA DA hiya votela EFF On the Beach, Bilene Mozambique	positive
Ni rungula nsati wamina nthabiseng mashaba ka xokwe nwana mina inocente mathonsi na mamani flora mathonsi ka xokwe Mozambique	positive
â€œA xwi chegui ka?â€ ğŸ˜­ğŸ˜­	negative
Kaya ka vo vovo. Nkanyini wa mgilo Magude	neutral
"ku laveca Mali, a ku laveke ntizo laku sasseka" âœğŸ¿	positive
Suka, xtapora: Niti dlela male ya Mina ğŸ¤ŒğŸ½ Toh ta falar, Noh ti dlela male yah Mina ğŸ˜‰	negative
. wo ai ni)	positive
Utwa mbangui wena	negative
Auxeni, hoyini Ku pfuka?ğŸ˜‰	positive
Ndlela yi rhandza mehe	positive
Ni bom bay	positive
Akusaka ka ndlama kopitira ku #Collerboxparty ndani ameneyo?	positive
"Kuni guala la? Kuni va fana la?" -Rupi Kaur	positive
Ova na vuntswaka lowa nhloko	negative
Va galhi tiMbatsana kaMarracuene.	positive
Auxene. Moine ku pfuka	positive
A Mavele ya ku tsamisseka	positive
Wali wa Dula ğŸ˜­	negative
Rixile vayakelany. Tasmani kurhula a sonto.	positive
Kanimambo Chikwembo xa MathimbağŸ™	positive
mina vhahaxi nipfukile ni ndlhua ni teka amungano wamina hitaya ntirweni nimukeme iwa hayo le'lhee.ğŸ˜‚atwa axirhami katitimela la magude	negative
Hi va khale ka mungangu lowo! ğŸ˜ğŸ	positive
Naminau kata na fhinavela acufamba ni ti tsaguela, cubo uia xplanada.	positive
Afinal fere a vista? ğŸ˜‚ğŸ˜‚ğŸ˜‚ Ni dzivaleli a ni nga swi tivi ğŸ¤£	negative
HAHAHAHAHA yu yu yu yu wa hi danissa.	negative
Hahahahah Futseka Wena ğŸ¤£ğŸ™†â€â™‚ï¸	negative
Ni ta rendera	negative
Tili luweme nase A Mulungu otisunga	negative
Ni ta ku ronha gotwana. ğŸ¶	negative
U ta mu vona lu lala nyana 2x Ku vi a dÃ¡ ti nga txayi ğŸ•ºğŸ¿	positive
Re tsogile re ra wena	positive
A mathapa na ma randza.	positive
Wena pah ğŸ˜‚ğŸ˜‚ğŸ˜‚ no thleka lano	positive
Ho hi danissa wena wananga	negative
Hini ya tsutsuma bai hee Malembe ni Malembe ka mugango lowo	positive
xilo ndla yin ni kayerini	neutral
Yeah,Famba a la mierda	negative
wow na khensa sesi mhana rivaldo vani khome kahle hi siku ra mina	positive
Namina ihm swa gambağŸ˜ Ja na viağŸ•ºğŸ¤‘	neutral
Nitaku panhula hi xinwui* xa tiroğŸ˜‚ğŸ˜‚	negative
Swa mbangue ni ma cigarri !	negative
Ku dliwa salada	positive
Bom domingo Hosi yi katekisa wena na njangu wa wena. Mhunti ya mona Soweto-em Casa Chokwe	positive
GÃ©rdio paah,pastor,pastor dza ku hini a hi sizi mani ! ğŸ˜‚ğŸ˜‚âœ‹	negative
Niku yingiseli niri ka xokwe Mozambique #mindzumba	positive
Loku u gwuira ni ta ku tsika ğŸ¶ ğŸ•ºğŸ¿	negative
John Legend - Mina Na Wena	positive
ğŸ˜‚ğŸ¤£ğŸ˜‚ğŸ¤£ğŸ˜‚ğŸ¤£ epah Yah afinal acontece la ğŸ˜‚ğŸ¤£ğŸ˜‚ğŸ¤£ğŸ˜‚ dzukuta para aqui dzukuta para ali ğŸ˜‚ğŸ¤£ğŸ˜‚ğŸ¤£,	positive
Akuna Xitomboo swaku thlanga ni Mboloo ğŸ‘¯â€â™€ï¸ğŸ‘¯â€â™€ï¸ğŸ‘¯â€â™€ï¸ğŸ‘¯â€â™€ï¸	neutral
Kama Bill Gates angekua ni nchi, basi angekua ni nchi ya 37 kwa utajiri duniani! #ElimikaWikiendi	neutral
Ho yini ku pfuka?	positive
Moya wa ku Xwenga	positive
U tadla biloko	negative
Hawena hinga ni tsika pah	negative
Jeremias Nguenha - La Famba Bixa Abilio Mandlaze - Juro Sinceramente Abilio Mandlaze - Ulava ni ti sunga	positive
i fanela hiku rhandza kereke naku faya miti ya vanhu	positive
A matapa na marandza, na marandza.	positive
Ku ta faciwa swa bom	positive
Joyous Celebration - Hi Hanya Mahala ğŸ“¶ğŸ“¶ğŸ“¶ğŸ“¶	positive
Nghoma ya Nghena ma onha mhaka . a mosambiki va cina hinoo #tag Nghena miva rungula Moamba, Maputo, Mozambique	positive
Ihh. A chirami ka lomuu!	negative
Malem ya ku tala ğŸ¶â¤	positive
Pfutseka! Para ti que ttaste	negative
ğŸ˜¹ğŸ˜¹ğŸ˜¹txuvuka leswi lani ğŸ˜¹ğŸ˜¹ğŸ˜¹ğŸ˜¹	positive
Le wena wa ba zoza?	neutral
Nina wena kola xokwe Mozambique uni endla yini mara 810dstv	positive
Happy birthday Mo G ğŸ‚. Aku Huma ni humaka (quarentena, wena para Nita dlaya ğŸ» ğŸºğŸ˜¹ğŸ˜¹ğŸ˜¹ #morelife	positive
ğŸ˜‚ğŸ˜‚ğŸ˜‚ ani nhlaya leswi ni swi vonaku	neutral
Morning swa mbangue	negative
U bihile demais, lokhu ulangunta hansi a xikwembo swo kubha I mazwidji. ğŸ¤£ğŸ¤£ğŸ¤£	negative
ALOKU NIKU IM. ğŸ˜› ğŸ‘ŠğŸ¿_/ \_ğŸ‘ŠğŸ¿ ( . ) ğŸ† ğŸ‘– YA BA BULUKO ğŸ˜¹ğŸƒ	positive
Hewe, thlanga u hluela!	positive
A xinkwa lexi xa le missaveni u ndzuluti we Tatana hakukombelağŸ’ƒğŸ’ƒğŸ’ƒ Lililili	positive
ni pulukhe, no undla a vana vavano	positive
ALOKU NIKU IM. ğŸ˜› ğŸ‘ŠğŸ¿_/ \_ğŸ‘ŠğŸ¿ ( . ) ğŸ† ğŸ‘– YABA BLACKFRIDAY ğŸ˜¹ğŸƒ	positive
Munhu wa mina ku saseka	positive
Ani gwenti hi ngoma ya luwei wah nwanhana â¤ï¸â¤ï¸â¤ï¸	positive
ğŸ˜‚ğŸ˜‚ğŸ˜‚ğŸ˜‚ I nkarhi wa malamula	positive
Outros ; YABA BULUKU ğŸŒ Outras ; LA KAMINA KUNA TXUKELA ğŸ Eu ; NOLAVHA KU PHUZA NIFAMBA ğŸ»	positive
ni pfukile va haxi nho kufumetanhana amuphungo nita kufumetanhana anhokana nitaya atirwene	positive
ğŸ¤£ why uni lembrara lexwu ğŸ˜¤ wena wa kazata	negative
Hi ta humula guwa	positive
Txuvuka dzanku logo uya wa kwela kuvuya ka wena hitaku yamukela	positive
A swilo swa matilo swi lava ku hiteka. , , , , ,	positive
U S â€¦ #AQORMV Ndlavela	neutral
A ni guenti ğŸ˜¹	positive
Hipfukile ingo wena?	positive
XÃ´ lava kunha sÃ³! Mara WA XI lumbeta	negative
porras ya, swi tÃ¡ gama hi merda	negative
ğŸ˜¹ğŸ˜¹ğŸ˜¹ğŸ˜¹ conforme mo swi vonaka	neutral
Ubakka Va ta zwa ku vava	negative
namina aniswi tivi swaku president mbalula di endle yini	negative
Uku ni dzo ğŸ˜‚ğŸ˜‚ğŸ˜‚ğŸ˜‚	negative
niku yingiseli nile xokwe Mozambique nilo gaa 810dstv	positive
Swo yini ku phfuka?	positive
ğŸ‘ UNI TXOVA YINI ğŸ‘	negative
Angihambi nawe wathi ngimubi wena	negative
Messi Wa Nhine ğŸ˜‚	negative
ğŸ˜‚ğŸ˜‚ğŸ˜‚ğŸ˜‚ğŸ˜‚ğŸ˜‚i rhandza mina, phela kuza xi rhandza camera hi kola ka mina	positive
ğŸ¤£ğŸ¤£ğŸ¤£ğŸ¤£ğŸ¤£ğŸ¤£ğŸ¤£ğŸ¤£ğŸ¤£ğŸ¤£famba u ya ti gunha hi parede.	negative
Ha tsovela kola chokwe Mozambique ni khensa mufundisi	positive
ğŸ˜‚ğŸ˜‚ğŸ˜‚Ina mas wa ma navela	positive
Timaka ku famba ngofo : hi nhimile kola Maracuene Maracuene	negative
Ubhema ama drugs wena.	negative
mi nga rivali ku happy birthday Eka mina	positive
Swa yantswa uti twisa hiku Loku uta famba vata sala vati busa Cidade De Chokwe	neutral
Eish vo ni kama ca chapa-.-'	negative
Ku lhamba vavakulo	neutral
SÃª vha ni vitile. Niya ti dakwela. Nitsama hansi, ni da nhama. Ni tlhela ni phuza, ni va nhenhentsa .	positive
Ni Teka ni famba ou no dÃ¡ ko halağŸ¤”	neutral
Mawako.muito nice ih	positive
Ni bom ,ni yetlelile bem .anhanti wena. humm. (loop.	positive
Ukanga umakuma lawa ya RAYMOND? Atakuvavisa madala.	positive
Futseka wena eh	negative
ğŸ™† hosi yanga ğŸ˜¹ğŸ˜¹ğŸ˜¹	negative
Na mukha ni ya Kaya	neutral
Wa swi tivela âœŠğŸ¾ğŸ”¥	positive
Hi honili ini jÃ¡?	negative
A wasati vomu taratara juroo A wasati vomu ghenissa salÃ£o a shongaa - vovo dele.	positive
Mina ni sati wanga* Jay â™¡ Maputo, Mozambique	positive
Conforme Mi Swi Vonaka!	neutral
Hewa ya Oxygen ğŸ˜	positive
Swi mbeni e mÃ¡ vagwi ya mÃ¡ like	negative
Uyaphi ku 2020 nendoda?	neutral
Obama, ce u dakwile (8)	negative
Oww ok ih	neutral
Uwani me chamou de marandza ihğŸ˜­ğŸ˜­ğŸ˜­ğŸ˜‚ğŸ˜‚ğŸ˜‚ğŸ˜‚ğŸ˜‚	negative
Wena, no ku Randza hi ku pimissa.	positive
Na hanya. Ni khensile. ğŸ™	positive
WA loya ğŸ˜‚ğŸ˜‚ğŸ˜‚	negative
Uta kuma timaka hi maka ma brincadeira	negative
Wa swi tivaa	positive
Hi tafa hi ndlala	negative
U bom mana tt ni yingiseli wena kola ka xokwe Mozambique	positive
Aha. Auxeni ti nguavani	negative
ğŸ˜‚ğŸ˜‚ğŸ˜‚ U ta Djikimela dzi mu tsika	neutral
Ani madururu npfana lweyiğŸ˜¹	negative
Ni li hinkwaxu ta xona Hi mintizo ya Xikwembu	positive
Pimissa nhana u tsika madururo	negative
A gwala hi phuzile	positive
Nikombela ku etlhela ğŸ˜¢ğŸ˜“	negative
Aaassh wena mani. ğŸ˜©ğŸ˜©ğŸ˜©ğŸ˜©ğŸ˜©ğŸ˜©ğŸ˜©ğŸ˜°	negative
high dj himi kuma kahle hirila Mozambique ka KHUBU hi 92.0 . I ADOLFO MIMBIRE KA KHUBU	negative
Misava yi Bihile ihhğŸ˜¤ğŸ˜¤â¤ï¸â¤ï¸ğŸ¤²ğŸ¤²ğŸ¤²ğŸ¤²	negative
Ya mas iih, nada ğŸ˜‚ğŸ˜‚	negative
Loku u hi wona hiku ta hi yena, hi yena Yehova, hi yena A loku u hi wona na hili so hi yena, hi yena Yehova, hi yena Oh hi yena Yehova, hi yena, hi yena ğŸ§ğŸ¶ğŸ¶ğŸ¶	positive
Swa vavissa vakithi, ho ondza na vo kuluka.	negative
Ehh yewe,ni lawa ku dog style ğŸ˜‚ğŸ˜‚ğŸ¶	neutral
Super sweet Sunday ka nsati wamina nthabiseng mashaba ka xokwe nwana mina inocente mamani flora mathonsi ka xokwe	positive
A I landzi* ti dhlela	positive
Ni rungula my love nthabiseng mashaba ka xokwe ka xingange niheta hi sivari Vicente sambo a putfontein	positive
ni bom, a caya kwaco khe?	positive
Na Wena ti twissi! A u hi voni Hina hi puzah mÃ¡ dswala na hidla ti nyama hita dzudza switresse Discover "Happy" by Mr Bow on Deezer	positive
Ku phuza bem 2M Flow	positive
Ni yingiseli kola Ka doroba laka CHOKWE 810 dstv niyo gee na vovo flora mathonsi	positive
Nifile ih wena	positive
Himakha mune lesho, Em Moz seria "ku ba mpama mina" durante.	negative
rixile vahaxi va mina nimi kuma kahle nirila Moz ka Khubu la. Obrigado	positive
Dzixilee, mo hine ku phuka.	positive
wakutiva amagude dj akaya kaya ka mina	neutral
mina na wena	positive
Nitaku panhula ih xinwe xa tiroğŸ˜‚	negative
tavuya vahaxi mahaka matorokisi ni muyingisile niri kola akaya AMAGUDE MOZA.MBIQUEğŸ’ªâœŒ	neutral
Wa yitiva wena kumbe hota mbangui loko yi nhiwe himbutiğŸ˜‚ğŸ˜‚ğŸ˜‚ğŸ˜ğŸ˜na weğŸ‘‰ ğŸ˜‚ğŸ˜	negative
Swa kharata mpela. Khambi. Funtsi a ih swi tsiki. ğŸ˜”	negative
Hayi ta humesa, ta humesa, ta humesa, ta humesağŸ’ƒğŸ’ƒ MasupağŸ˜ğŸ¶ğŸ¤ŸğŸ¼	positive
ğŸ˜‚ğŸ˜‚ğŸ˜‚ğŸ˜‚ keep voning. Na ku xuvha	positive
Pfa khenseka pfoleswo! Namini ni bom, a Xikwembo xÃ¡ dzi hlayisa! ğŸ˜Š	positive
Ni kola Ka xingange vani khome bom MA's and Ku tlangeliwa birthday	positive
ğŸ˜‚ğŸ˜‚ğŸ˜‚ğŸ˜‚ eka ğŸ¤®ğŸ¤¢ Teka famba Big ğŸ˜»ğŸ˜»ğŸ˜»ğŸ˜»	neutral
A Nina male minoo, noh tivha ku kina (blaze's voice)	positive
Swa hini? A ukanho dza bom!	positive
ğŸ˜‚ mu randza xwa Mahala	negative
Hi Nkomu! Mo hini hi ku pfuka ?	positive
Munganu leswi swa lhanhelana bha , upimissa swaku o miss universo loku upfuka yuu uli hansi	negative
deve nikuh loya XA loya	negative
Poora gramo mng de Mathapa pah foodaz. Patsa Ni ma hanti	positive
Nambe mina. Ni pfhuki kwatse. Khanimambo	positive
mina se lindivarr mina aita navhela aku teka giyane nitsakisa hi xibelane niri kola a magude	positive
i ckali nitlanga hi tinamba.ğŸğŸ‚	positive
A xitiloo xa boby hii nchine.	neutral
Swa* banana pah Mas passamos na mesma	positive
Loku ungali wa mina swa yaswa ussussa mbilo ya mina	negative
Uh tah ssala va uhlolo	positive
nimu yingisela nile ka xokwe Mozambique 810dstv	neutral
Tsika ku hanha hutomi dza vamwanhane ğŸ˜Š	negative
Raha pfurha ka nsati wamina nthabiseng mashaba ka xokwe	neutral
Hii ni livrarih !	negative
Hambi uku nhÃ³ ğŸ™„, um dia uta sunguna ku phuza na mesmağŸš¶ğŸš¶ğŸš¶	negative
Dzixile ho yine ku pfuka?	positive
Maningue ğŸ˜‚ğŸ˜‚ğŸ˜‚ Khanimambo. U pfhukile?	positive
Ni pfhukile. A va tsongwana va thlanga. Khanimambo ğŸ™ğŸ¾	positive
Cada porcaria. Hosi yanga	negative
niku 10 ma garrafa	positive
F U pah ğŸ˜‚ğŸ˜‚ğŸ˜‚ğŸ˜‚ğŸ˜‚	negative
MINGAS - Alirandzo. MINGAS - Mamana. ANIANO TAMELE - papai se hi fikile.	positive
Teka famba bro ğŸ˜‹ğŸ˜‚	positive
awuxeni va haxi va mina va nduma mina nipfukile nho dja mpungu ni lava akuya dsundzisa aritiwa ramina nihlaula amudji watimali	positive
Mi svi vonakağŸ˜¹	neutral
Ni huma na marhama hey , khensa nsati wa mina wani hlayisa xem â¤â¤â¤â¤â¤	positive
Kkklk ni kombela uni sendela ka whatsup	positive
Tana u ta dya.	positive
"Wansati wa ku xonga ku tlhula wene? Animutive minoo?"	positive
Hina matxangana vah hi tiva hiku tsaka ğŸ˜‚ğŸ˜‚ğŸ˜‚ğŸ˜‚	positive
Wenna hu ta ni txanissa ih voz man	negative
U ta famba maTilweni	positive
Ni lava male sÃ³ğŸ’¯ğŸ¥°	positive
"Tsemba Jehova/ Wene nwana wa Xikwembu" - #QuartaDeQuotes	positive
Va xisati hi kotala avana sapoti wansati hambi loko ari president u tsaka hi kuxaveliwa vatlela vadiziwa. niri la moz	negative
#Xiluvaxangaa #Mina ni langui wene Top top top ğŸ’ƒ bow	positive
#HHW boti unga vileli Xikwembu xita hlayisa sesi vana mbilo ya sathana	negative
Ni humile ğŸ˜…ğŸ˜…	positive
admitam, mu vha yive nwine.	negative
hahahah u ta rendera	negative
Nhee ni tsike	negative
"A loko wa nuna a baleca wa nsati nambe hele bonita. Xicona, xicona lexi xi balequisaca lueyi wa papa."	negative
"Xikwembu ni nyike matimba."	positive
Yu , tindzava ? Tsika mbangui mpfana e nita ku desprogramara	negative
Dadinhaz around tha world hani tsikka ka maputo afamba a tshama london	negative
Acula ai = aquilo ali. Mawaku ğŸ™ŒğŸ¾ğŸ™ŒğŸ¾ğŸ™ŒğŸ¾ğŸ˜‚ wa hi danissa juro	negative
Auditoria wa matximba	negative
Wena uni ntxumo uxi mahaka ni guele, ingui u bom pra puto puto, mas haa	negative
Jimmy Dludlu - Mu Tumbelelwana ğŸ¶âœ¨	positive
Ihh ih ih ih um perigoso awenaa	negative
Teka Famba B.Jardim	positive
taku endlela naha faka tinambara ta wena ka whatsapp leya xiputukezi	neutral
Ahu xitwi xizami papÃ¡ ğŸ˜­	negative
A nuna wa wena i malandro	negative
Wa hlanha lweyiğŸ˜‚ğŸ˜‚	negative
Ni pfhukile. Ho ini kupfhuka?	positive
ğŸ˜‚ğŸ˜‚ğŸ˜‚ğŸ˜‚ğŸ˜‚ğŸ˜‚ğŸ˜‚ Ina marha ya mina yi famba mahlweni hiti cup masiku lawa	positive
Ya va dudamel deja la vino tinto vermo	positive
Mas Khasi a u teke nsati hi maka muni?	negative
ene swi valavula ntiyiso ğŸ˜‚ğŸ˜‚ğŸ˜‚ğŸ˜‚ğŸ˜‚ğŸ˜‚	positive
Mhunti ya mona Soweto-em Casa Chokwe	negative
uh dzah ih mbangue Mr Virgil	negative
Dzixile, Na Mi Lossa Va Yakelani.â˜€â˜€	positive
EdjÃ´ ' Aloko niku %â‚¬&amp) ni biwa hi Zululuane ğŸ™Œ	negative
Hai wena mun ! ğŸ™ŒğŸ»	neutral
": ": Mina a ni tsama ka twitter timaka xkola ğŸ˜‚ğŸ™Œ" Mine Ani Tsame ) Himaka* ) ." thanks .	positive
Ni bom by Noh Dja djuala ntse	positive
Na hanya. Aswina ku kazata. Khanimambo	positive
Aleluia xikwembo xa matimba tlhatteka vhoko dzaku ku Hina vana wakhu hi kombela a matimba yaku	positive
A xizami ehh ğŸ˜­	negative
minjane vahaxi vhantokoto mina nipfukile nonyimela ankama waphaphama wu hela nita kota a kuya ntirwene, hikuva akutireke loko kahana nwina vhahaxi	neutral
Nimu yingiseli nile chokwe Mozambique vahaxi vamina va qualidade zwimbiri2	positive
Wa ni Danissa ğŸ™„	negative
hiri ni nghena	neutral
Ahii Loloza male ya Manhembana :D	positive
ğŸ¤£ğŸ¤£ğŸ¤£ pÃ´di ni xava? Ndjaku kalhula a mintxumo.	neutral
Na hanha. NÃ´ scrolaranhana, ni hamba nkama pra niya Studio.	positive
ja wena Stella.	neutral
"Mi nga koloti munhu xanchumu, loko ku nga ri ku rhandzana; hikuva loyi a rhandzaka munhu-kulobye u wu hetisisile nawu" - Varhoma 13:8	neutral
Swimbenhane vata hi rhivalela mas ava futseke.	negative
A ku xonga ğŸ˜‡	positive
Famba moyeni bafanas!	neutral
A Pandza wa kho ğŸ•ºğŸ½	positive
Khasi u djulaa niku hini mamanee!	negative
Ningene na nwina eka 2020 nili kwala Mozambique ka Macia, hi xohondzo lexi 92.0	neutral
Hinkhomo. mo yini hi ku pfuka?	positive
Nwana Makhuvele Mukonwana wa Khosa. Ntukulu wa Manyike. Feliz dia do pai Mhunti ya mona â€¦	positive
swiswi ni vona Gavin a hindzela mahlweni	positive
Vataku yivissa mova mamanou, owooh. Wa tlanga wena. Keep tlanguing, uta dzila.	negative
na mina nimi kuma kahle nirila Moz ka Khubu	positive
Ni yingiseli wena sesi khensi nile xokwe Mozambique	positive
Swa yantswa niva mbuya, nita Kuma ma regalias ğŸ˜’	positive
Swi tivissi swi biya kk	negative
A loko niko hi matilho lo bindza,minengue wo tiya	negative
nipfukile vhahaxi niya atirweni ni ndlhula nixava amapawa dj iwamativağŸ˜‚	positive
Nikola Ka xingangi Ka nwina	positive
Todos escutamos mina ninguÃ© fambi yi lÃ¡ ğŸ˜‚ğŸ˜‚	neutral
ğŸ˜¹ğŸ˜¹ğŸ˜¹ğŸ˜¹ğŸ˜¹ EDM, djoh. Wa hi danissa	negative
â€œYa Maning, ya Maning, ya Maning.â€	positive
Amitxino ya barhule yifambisana nitisimu ta yenağŸ˜‚iswo rhuketela hikwaswo	negative
Ni cizi weni, unga buyi ni taku.	positive
Phula minegue ni diwa atÃ© ku huma ndzilo	neutral
He mfoo wa xitwa xipapilani xa kokwani Dala	neutral
A lirandzu la patima!	positive
Ya, mapfilwa Ã© assim mesmo.	positive
